Time,Team,Operation,BuyVolume,SellVolume,EtfPosition,FuturePosition,EtfPrice,FuturePrice,TotalFees,AccountBalance,ProfitOrLoss,Status
0.0,TraderOne,Tick,0,0,0,0,,,0,0,0,OK
0.219,TraderOne,Tick,0,0,0,0,,,0,0,0,OK
0.453,TraderOne,Tick,0,0,0,0,,,0,0,0,OK
0.75,TraderOne,Tick,0,0,0,0,,,0,0,0,OK
0.985,TraderOne,Tick,0,10,-10,10,147600,,-147,147,147,OK
1.219,TraderOne,Tick,0,10,-10,10,147600,147100,-147,147,-1853,OK
1.5,TraderOne,Tick,1,10,-9,9,147000,147100,-118,118,1018,OK
1.735,TraderOne,Tick,1,10,-9,9,147000,147100,-118,118,1018,OK
1.985,TraderOne,Tick,1,10,-9,9,147000,147100,-118,118,1018,OK
2.297,TraderOne,Tick,1,10,-9,9,147000,146900,-118,118,-782,OK
2.547,TraderOne,Tick,1,10,-9,9,146400,146900,-118,118,1918,OK
2.75,TraderOne,Tick,1,10,-9,9,146400,146900,-118,118,1918,OK
3.0,TraderOne,Tick,1,10,-9,9,146400,146900,-118,118,1918,OK
3.282,TraderOne,Tick,1,10,-9,9,146400,146900,-118,118,1918,OK
3.547,TraderOne,Tick,1,10,-9,9,147500,146900,-118,118,-1682,OK
3.735,TraderOne,Tick,11,10,1,-1,146300,146900,-265,1265,1065,OK
4.032,TraderOne,Tick,11,10,1,-1,146300,146900,-265,1265,1065,OK
4.282,TraderOne,Tick,11,10,1,-1,146300,146900,-265,1265,1065,OK
4.532,TraderOne,Tick,21,10,11,-11,146300,146900,-412,1412,-788,OK
4.797,TraderOne,Tick,21,10,11,-11,146300,146900,-412,1412,-788,OK
5.063,TraderOne,Tick,21,10,11,-11,146300,146900,-412,1412,-788,OK
5.282,TraderOne,Tick,21,10,11,-11,146300,146800,-412,1412,-788,OK
5.5,TraderOne,Tick,21,10,11,-11,146300,146800,-412,1412,-788,OK
5.735,TraderOne,Tick,21,10,11,-11,146300,146800,-412,1412,-788,OK
6.063,TraderOne,Tick,21,10,11,-11,146300,146800,-412,1412,-788,OK
6.203,TraderOne,Tick,21,20,1,-1,147000,146800,-118,2118,2318,OK
6.516,TraderOne,Tick,21,30,-9,9,147000,146800,176,3824,2024,OK
6.813,TraderOne,Tick,21,30,-9,9,147200,146700,176,3824,2024,OK
6.985,TraderOne,Tick,21,30,-9,9,147200,146900,176,3824,2024,OK
7.25,TraderOne,Tick,21,30,-9,9,147200,146900,176,3824,2024,OK
7.453,TraderOne,Tick,21,30,-9,9,147200,146900,176,3824,2024,OK
7.719,TraderOne,Tick,21,30,-9,9,147200,146900,176,3824,2024,OK
8.063,TraderOne,Tick,21,30,-9,9,147200,146900,176,3824,2024,OK
8.203,TraderOne,Tick,21,40,-19,19,147000,146900,470,3530,1630,OK
8.5,TraderOne,Tick,21,50,-29,29,147000,146900,764,3236,336,OK
8.75,TraderOne,Tick,21,60,-39,39,147000,146900,1058,2942,-958,OK
8.985,TraderOne,Tick,31,69,-38,38,146600,146900,1176,4724,12324,OK
9.235,TraderOne,Tick,41,69,-28,28,146400,146900,1469,7431,13031,OK
9.516,TraderOne,Tick,51,69,-18,18,146400,146900,1762,10138,13738,OK
9.797,TraderOne,Tick,61,69,-8,8,146400,146900,2055,11845,13445,OK
9.953,TraderOne,Tick,71,69,2,-2,146400,146900,2348,12552,12152,OK
10.297,TraderOne,Tick,81,69,12,-12,146400,146900,2641,14259,11859,OK
10.516,TraderOne,Tick,81,69,12,-12,146400,146900,2641,14259,11859,OK
10.766,TraderOne,Tick,81,69,12,-12,146400,147000,2641,14259,11859,OK
11.047,TraderOne,Tick,81,69,12,-12,147300,147000,2641,14259,16659,OK
11.219,TraderOne,Tick,81,69,12,-12,147300,147000,2641,14259,16659,OK
11.5,TraderOne,Tick,81,69,12,-12,147300,147000,2641,14259,16659,OK
11.719,TraderOne,Tick,81,69,12,-12,147300,147200,2641,14259,15459,OK
11.985,TraderOne,Tick,81,79,2,-2,147400,147200,2494,15406,15806,OK
12.203,TraderOne,Tick,81,79,2,-2,147400,147200,2494,15406,15806,OK
12.516,TraderOne,Tick,81,79,2,-2,147400,147200,2494,15406,15806,OK
12.766,TraderOne,Tick,81,79,2,-2,147400,147200,2494,15406,15806,OK
13.0,TraderOne,Tick,81,79,2,-2,147400,147200,2494,15406,15806,OK
13.235,TraderOne,Tick,91,79,12,-12,146700,147200,2347,15553,13153,OK
13.453,TraderOne,Tick,91,79,12,-12,146700,147200,2347,15553,13153,OK
13.782,TraderOne,Tick,91,79,12,-12,146700,147200,2347,15553,13153,OK
14.0,TraderOne,Tick,91,79,12,-12,146700,147200,2347,15553,13153,OK
14.297,TraderOne,Tick,91,79,12,-12,146700,147200,2347,15553,13153,OK
14.485,TraderOne,Tick,101,79,22,-22,146900,147200,2200,16700,12300,OK
14.797,TraderOne,Tick,101,79,22,-22,146900,147200,2200,16700,12300,OK
14.953,TraderOne,Tick,111,79,32,-32,146900,147200,2494,16406,10006,OK
15.297,TraderOne,Tick,111,79,32,-32,146900,147200,2494,16406,10006,OK
15.532,TraderOne,Tick,111,79,32,-32,146900,146800,2494,16406,19606,OK
15.735,TraderOne,Tick,111,79,32,-32,146900,146800,2494,16406,19606,OK
16.047,TraderOne,Tick,111,79,32,-32,146900,146900,2494,16406,16406,OK
16.282,TraderOne,Tick,111,79,32,-32,146900,146900,2494,16406,16406,OK
16.485,TraderOne,Tick,111,79,32,-32,146900,146900,2494,16406,16406,OK
16.735,TraderOne,Tick,111,79,32,-32,146900,146900,2494,16406,16406,OK
17.016,TraderOne,Tick,111,79,32,-32,146900,146900,2494,16406,16406,OK
17.282,TraderOne,Tick,111,79,32,-32,146900,146900,2494,16406,16406,OK
17.5,TraderOne,Tick,111,79,32,-32,146900,146900,2494,16406,16406,OK
17.735,TraderOne,Tick,121,79,42,-42,146900,146900,2788,17112,17112,OK
18.032,TraderOne,Tick,131,79,52,-52,146600,146900,3082,17818,7418,OK
18.297,TraderOne,Tick,131,79,52,-52,146600,146900,3082,17818,7418,OK
18.453,TraderOne,Tick,131,79,52,-52,146600,147100,3082,17818,7418,OK
18.797,TraderOne,Tick,131,79,52,-52,146600,147100,3082,17818,7418,OK
19.0,TraderOne,Tick,135,79,56,-56,146900,147100,3200,18100,6900,OK
19.266,TraderOne,Tick,145,79,66,-66,147000,147100,3494,17806,11206,OK
19.516,TraderOne,Tick,145,79,66,-66,147000,147200,3494,17806,4606,OK
19.782,TraderOne,Tick,145,79,66,-66,147000,147200,3494,17806,4606,OK
19.953,TraderOne,Tick,145,79,66,-66,147000,147200,3494,17806,4606,OK
20.219,TraderOne,Tick,145,79,66,-66,147000,147200,3494,17806,4606,OK
20.516,TraderOne,Tick,155,79,76,-76,147000,147900,3788,21512,6312,OK
20.703,TraderOne,Tick,155,79,76,-76,147200,147900,3788,21512,6312,OK
20.969,TraderOne,Tick,155,79,76,-76,147500,147900,3788,21512,6312,OK
21.282,TraderOne,Tick,155,79,76,-76,147500,147900,3788,21512,6312,OK
21.547,TraderOne,Tick,155,79,76,-76,147500,147900,3788,21512,6312,OK
21.719,TraderOne,Tick,155,79,76,-76,147500,147900,3788,21512,6312,OK
21.969,TraderOne,Tick,155,79,76,-76,147500,148000,3788,21512,6312,OK
22.25,TraderOne,Tick,155,79,76,-76,147500,148000,3788,21512,6312,OK
22.532,TraderOne,Tick,155,79,76,-76,147500,148100,3788,21512,6312,OK
22.797,TraderOne,Tick,165,79,86,-86,147700,148100,4083,25217,8017,OK
23.063,TraderOne,Tick,165,79,86,-86,147700,148000,4083,25217,8017,OK
23.313,TraderOne,Tick,165,79,86,-86,147700,148000,4083,25217,8017,OK
23.516,TraderOne,Tick,165,79,86,-86,147700,147700,4083,25217,25217,OK
23.766,TraderOne,Tick,165,79,86,-86,147700,147700,4083,25217,25217,OK
24.0,TraderOne,Tick,170,79,91,-91,147600,147700,4009,25791,16691,OK
24.25,TraderOne,Tick,170,79,91,-91,147600,147700,4009,25791,16691,OK
24.5,TraderOne,Tick,170,79,91,-91,147600,147700,4009,25791,16691,OK
24.75,TraderOne,Tick,170,79,91,-91,147600,147700,4009,25791,16691,OK
25.016,TraderOne,Tick,170,79,91,-91,147600,148100,4009,25791,7591,OK
25.266,TraderOne,Tick,170,79,91,-91,147700,148200,4009,25791,7591,OK
25.469,TraderOne,Tick,170,79,91,-91,147700,147900,4009,25791,7591,OK
25.719,TraderOne,Tick,170,79,91,-91,147700,147900,4009,25791,7591,OK
26.063,TraderOne,Tick,170,79,91,-91,147700,147900,4009,25791,7591,OK
26.297,TraderOne,Tick,170,79,91,-91,147700,147900,4009,25791,7591,OK
26.453,TraderOne,Tick,170,79,91,-91,147700,147900,4009,25791,7591,OK
26.766,TraderOne,Tick,170,79,91,-91,147400,147900,4009,25791,7591,OK
27.0,TraderOne,Tick,170,79,91,-91,147400,147900,4009,25791,7591,OK
27.25,TraderOne,Tick,170,79,91,-91,147400,147900,4009,25791,7591,OK
27.516,TraderOne,Tick,170,79,91,-91,147400,147900,4009,25791,7591,OK
27.797,TraderOne,Tick,170,79,91,-91,147400,147800,4009,25791,7591,OK
28.047,TraderOne,Tick,170,79,91,-91,147200,147800,4009,25791,7591,OK
28.282,TraderOne,Tick,170,79,91,-91,147700,147800,4009,25791,16691,OK
28.516,TraderOne,Tick,170,79,91,-91,147700,147800,4009,25791,16691,OK
28.75,TraderOne,Tick,170,79,91,-91,147700,147600,4009,25791,34891,OK
28.969,TraderOne,Tick,170,79,91,-91,147700,147600,4009,25791,34891,OK
29.266,TraderOne,Tick,170,79,91,-91,147700,147600,4009,25791,34891,OK
29.469,TraderOne,Tick,170,79,91,-91,147700,147600,4009,25791,34891,OK
29.782,TraderOne,Tick,170,79,91,-91,147700,147600,4009,25791,34891,OK
30.032,TraderOne,Tick,170,79,91,-91,147700,147600,4009,25791,34891,OK
30.25,TraderOne,Tick,170,79,91,-91,147700,147600,4009,25791,34891,OK
30.532,TraderOne,Tick,170,79,91,-91,147700,147600,4009,25791,34891,OK
30.75,TraderOne,Tick,170,79,91,-91,147700,147400,4009,25791,43991,OK
31.016,TraderOne,Tick,170,79,91,-91,147700,147400,4009,25791,43991,OK
31.203,TraderOne,Tick,170,79,91,-91,147700,147400,4009,25791,43991,OK
31.485,TraderOne,Tick,170,79,91,-91,147000,147400,4009,25791,7591,OK
31.75,TraderOne,Tick,170,79,91,-91,147000,147400,4009,25791,7591,OK
31.969,TraderOne,Tick,170,79,91,-91,147000,147400,4009,25791,7591,OK
32.266,TraderOne,Tick,170,79,91,-91,147000,147400,4009,25791,7591,OK
32.453,TraderOne,Tick,170,79,91,-91,147000,147400,4009,25791,7591,OK
32.797,TraderOne,Tick,170,79,91,-91,147000,147600,4009,25791,7591,OK
32.953,TraderOne,Tick,170,79,91,-91,147000,147600,4009,25791,7591,OK
33.297,TraderOne,Tick,170,79,91,-91,147000,147600,4009,25791,7591,OK
33.516,TraderOne,Tick,170,79,91,-91,147000,147600,4009,25791,7591,OK
33.766,TraderOne,Tick,170,79,91,-91,146900,147600,4009,25791,7591,OK
33.985,TraderOne,Tick,170,79,91,-91,146900,147600,4009,25791,7591,OK
34.203,TraderOne,Tick,170,79,91,-91,146900,147200,4009,25791,7591,OK
34.516,TraderOne,Tick,170,79,91,-91,146900,147200,4009,25791,7591,OK
34.797,TraderOne,Tick,170,79,91,-91,146900,147200,4009,25791,7591,OK
34.985,TraderOne,Tick,170,79,91,-91,146900,147200,4009,25791,7591,OK
35.203,TraderOne,Tick,170,79,91,-91,146900,147300,4009,25791,7591,OK
35.532,TraderOne,Tick,170,79,91,-91,147100,147000,4009,25791,34891,OK
35.766,TraderOne,Tick,170,79,91,-91,147100,147000,4009,25791,34891,OK
36.0,TraderOne,Tick,170,79,91,-91,147100,147000,4009,25791,34891,OK
36.266,TraderOne,Tick,170,79,91,-91,147100,147000,4009,25791,34891,OK
36.469,TraderOne,Tick,170,79,91,-91,147100,147000,4009,25791,34891,OK
36.766,TraderOne,Tick,170,79,91,-91,147100,147000,4009,25791,34891,OK
37.016,TraderOne,Tick,170,79,91,-91,147100,147000,4009,25791,34891,OK
37.235,TraderOne,Tick,170,79,91,-91,147100,147000,4009,25791,34891,OK
37.469,TraderOne,Tick,170,79,91,-91,147100,147300,4009,25791,7591,OK
37.766,TraderOne,Tick,170,79,91,-91,147100,147300,4009,25791,7591,OK
38.0,TraderOne,Tick,170,79,91,-91,147100,147300,4009,25791,7591,OK
38.266,TraderOne,Tick,170,79,91,-91,147100,147300,4009,25791,7591,OK
38.469,TraderOne,Tick,170,79,91,-91,147100,147300,4009,25791,7591,OK
38.735,TraderOne,Tick,170,79,91,-91,147100,147300,4009,25791,7591,OK
39.016,TraderOne,Tick,170,79,91,-91,147100,147300,4009,25791,7591,OK
39.266,TraderOne,Tick,170,79,91,-91,147500,147300,4009,25791,43991,OK
39.532,TraderOne,Tick,170,79,91,-91,147700,147300,4009,25791,43991,OK
39.719,TraderOne,Tick,170,79,91,-91,147700,147300,4009,25791,43991,OK
40.0,TraderOne,Tick,170,79,91,-91,147700,147300,4009,25791,43991,OK
40.297,TraderOne,Tick,170,79,91,-91,147700,147300,4009,25791,43991,OK
40.516,TraderOne,Tick,170,89,81,-81,147800,147300,3861,25939,42139,OK
40.735,TraderOne,Tick,170,89,81,-81,147800,147300,3861,25939,42139,OK
41.0,TraderOne,Tick,170,89,81,-81,147800,147300,3861,25939,42139,OK
41.203,TraderOne,Tick,170,89,81,-81,147800,147300,3861,25939,42139,OK
41.547,TraderOne,Tick,170,89,81,-81,147800,147300,3861,25939,42139,OK
41.782,TraderOne,Tick,170,89,81,-81,147800,147300,3861,25939,42139,OK
41.969,TraderOne,Tick,170,89,81,-81,147800,147300,3861,25939,42139,OK
42.266,TraderOne,Tick,170,89,81,-81,147700,147200,3861,25939,42139,OK
42.547,TraderOne,Tick,170,89,81,-81,147700,147200,3861,25939,42139,OK
42.703,TraderOne,Tick,170,89,81,-81,147700,147200,3861,25939,42139,OK
42.953,TraderOne,Tick,170,89,81,-81,147700,147200,3861,25939,42139,OK
43.219,TraderOne,Tick,170,89,81,-81,147700,147200,3861,25939,42139,OK
43.485,TraderOne,Tick,170,89,81,-81,147700,147200,3861,25939,42139,OK
43.75,TraderOne,Tick,170,89,81,-81,147700,147400,3861,25939,42139,OK
43.953,TraderOne,Tick,170,89,81,-81,147700,147400,3861,25939,42139,OK
44.266,TraderOne,Tick,170,89,81,-81,147700,147400,3861,25939,42139,OK
44.453,TraderOne,Tick,170,89,81,-81,147700,147400,3861,25939,42139,OK
44.75,TraderOne,Tick,170,89,81,-81,147700,147400,3861,25939,42139,OK
45.047,TraderOne,Tick,170,99,71,-71,147700,147400,3713,27087,41287,OK
45.25,TraderOne,Tick,170,99,71,-71,147700,147500,3713,27087,41287,OK
45.485,TraderOne,Tick,170,99,71,-71,147700,147500,3713,27087,41287,OK
45.703,TraderOne,Tick,170,99,71,-71,147700,147500,3713,27087,41287,OK
46.0,TraderOne,Tick,170,99,71,-71,147700,147500,3713,27087,41287,OK
46.25,TraderOne,Tick,170,109,61,-61,147400,147500,4008,26792,20692,OK
46.532,TraderOne,Tick,170,117,53,-53,147400,147500,4244,25756,20456,OK
46.75,TraderOne,Tick,170,117,53,-53,147400,147500,4244,25756,20456,OK
46.985,TraderOne,Tick,170,117,53,-53,147400,147500,4244,25756,20456,OK
47.25,TraderOne,Tick,170,117,53,-53,147400,147500,4244,25756,20456,OK
47.485,TraderOne,Tick,170,117,53,-53,147400,147500,4244,25756,20456,OK
47.735,TraderOne,Tick,170,127,43,-43,147700,147500,4096,26904,35504,OK
48.047,TraderOne,Tick,170,127,43,-43,147700,147500,4096,26904,35504,OK
48.297,TraderOne,Tick,170,127,43,-43,147100,147500,4096,26904,18304,OK
48.5,TraderOne,Tick,170,127,43,-43,147100,147500,4096,26904,18304,OK
48.782,TraderOne,Tick,170,127,43,-43,147100,147500,4096,26904,18304,OK
49.016,TraderOne,Tick,170,127,43,-43,147100,147500,4096,26904,18304,OK
49.25,TraderOne,Tick,170,127,43,-43,147100,147500,4096,26904,18304,OK
49.547,TraderOne,Tick,170,127,43,-43,147100,147500,4096,26904,18304,OK
49.797,TraderOne,Tick,170,127,43,-43,147100,147500,4096,26904,18304,OK
50.032,TraderOne,Tick,170,127,43,-43,147100,147500,4096,26904,18304,OK
50.25,TraderOne,Tick,170,127,43,-43,147100,147500,4096,26904,18304,OK
50.453,TraderOne,Tick,170,137,33,-33,147700,147500,3948,26052,32652,OK
50.782,TraderOne,Tick,170,137,33,-33,147700,147500,3948,26052,32652,OK
50.969,TraderOne,Tick,170,137,33,-33,147700,147500,3948,26052,32652,OK
51.235,TraderOne,Tick,170,137,33,-33,147700,147500,3948,26052,32652,OK
51.532,TraderOne,Tick,170,137,33,-33,147700,147500,3948,26052,32652,OK
51.797,TraderOne,Tick,170,137,33,-33,147700,147500,3948,26052,32652,OK
52.0,TraderOne,Tick,170,137,33,-33,147700,147300,3948,26052,32652,OK
52.25,TraderOne,Tick,170,137,33,-33,147700,147300,3948,26052,32652,OK
52.516,TraderOne,Tick,170,137,33,-33,147700,147300,3948,26052,32652,OK
52.735,TraderOne,Tick,170,137,33,-33,147700,147300,3948,26052,32652,OK
52.953,TraderOne,Tick,170,137,33,-33,147700,147300,3948,26052,32652,OK
53.203,TraderOne,Tick,170,137,33,-33,147700,147300,3948,26052,32652,OK
53.5,TraderOne,Tick,170,137,33,-33,147700,147300,3948,26052,32652,OK
53.735,TraderOne,Tick,170,137,33,-33,147700,147300,3948,26052,32652,OK
54.016,TraderOne,Tick,170,147,23,-33,147900,147300,3801,1500199,31799,OK
54.25,TraderOne,Tick,170,147,23,-23,147900,147300,3801,24199,28799,OK
54.532,TraderOne,Tick,170,147,23,-23,147900,147200,3801,24199,28799,OK
54.766,TraderOne,Tick,170,147,23,-23,147900,147200,3801,24199,28799,OK
55.0,TraderOne,Tick,170,147,23,-23,147900,147200,3801,24199,28799,OK
55.266,TraderOne,Tick,170,157,13,-13,147300,147300,4096,23904,23904,OK
55.532,TraderOne,Tick,170,157,13,-13,147300,146900,4096,23904,26504,OK
55.719,TraderOne,Tick,170,157,13,-13,147000,146900,4096,23904,25204,OK
56.032,TraderOne,Tick,170,157,13,-13,147000,147100,4096,23904,22604,OK
56.219,TraderOne,Tick,170,157,13,-13,147000,147100,4096,23904,22604,OK
56.532,TraderOne,Tick,170,157,13,-13,147000,147100,4096,23904,22604,OK
56.782,TraderOne,Tick,170,157,13,-13,147000,147100,4096,23904,22604,OK
57.032,TraderOne,Tick,170,157,13,-13,147000,147100,4096,23904,22604,OK
57.266,TraderOne,Tick,170,167,3,-3,147000,147100,4390,24610,24310,OK
57.485,TraderOne,Tick,170,177,-7,7,146900,146800,4684,24616,23916,OK
57.797,TraderOne,Tick,170,187,-17,17,146900,146600,4978,26322,22922,OK
58.0,TraderOne,Tick,170,197,-27,27,146900,146600,5272,28028,22628,OK
58.266,TraderOne,Tick,170,207,-37,37,146900,146700,5566,29734,22334,OK
58.5,TraderOne,Tick,170,217,-47,47,146900,146700,5860,30440,21040,OK
58.797,TraderOne,Tick,170,227,-57,57,146800,146700,6153,29747,24047,OK
59.032,TraderOne,Tick,170,237,-67,67,146800,146700,6447,30453,23753,OK
59.282,TraderOne,Tick,170,237,-67,67,146800,146700,6447,30453,23753,OK
59.5,TraderOne,Tick,170,237,-67,67,146800,146500,6447,30453,17053,OK
59.782,TraderOne,Tick,170,237,-67,67,146800,146500,6447,30453,17053,OK
60.0,TraderOne,Tick,170,237,-67,67,146800,146500,6447,30453,17053,OK
60.282,TraderOne,Tick,170,237,-67,67,146800,146700,6447,30453,23753,OK
60.485,TraderOne,Tick,170,237,-67,67,146800,146700,6447,30453,23753,OK
60.797,TraderOne,Tick,170,237,-67,67,146800,146500,6447,30453,17053,OK
60.953,TraderOne,Tick,170,247,-77,77,146800,146500,6741,31159,15759,OK
61.297,TraderOne,Tick,170,257,-87,87,146800,146500,7035,31865,14465,OK
61.485,TraderOne,Tick,170,267,-97,97,146800,146500,7329,32571,13171,OK
61.75,TraderOne,Tick,170,267,-97,97,146800,146500,7329,32571,13171,OK
61.969,TraderOne,Tick,170,267,-97,97,146800,146500,7329,32571,13171,OK
62.235,TraderOne,Tick,170,267,-97,97,146800,146500,7329,32571,13171,OK
62.547,TraderOne,Tick,170,267,-97,97,146700,146300,7329,32571,13171,OK
62.703,TraderOne,Tick,170,267,-97,97,146700,146300,7329,32571,13171,OK
63.047,TraderOne,Tick,170,267,-97,97,146700,146300,7329,32571,13171,OK
63.25,TraderOne,Tick,170,267,-97,97,146700,146300,7329,32571,13171,OK
63.453,TraderOne,Tick,170,267,-97,97,146700,146300,7329,32571,13171,OK
63.797,TraderOne,Tick,170,267,-97,97,146700,146300,7329,32571,13171,OK
63.953,TraderOne,Tick,170,267,-97,97,146700,146300,7329,32571,13171,OK
64.203,TraderOne,Tick,170,267,-97,97,146700,146300,7329,32571,13171,OK
64.485,TraderOne,Tick,170,267,-97,97,146700,146300,7329,32571,13171,OK
64.703,TraderOne,Tick,170,267,-97,97,146700,146300,7329,32571,13171,OK
64.953,TraderOne,Tick,170,267,-97,97,146700,146300,7329,32571,13171,OK
65.219,TraderOne,Tick,170,267,-97,97,146700,146900,7329,32571,51971,OK
65.5,TraderOne,Tick,170,267,-97,97,146700,146900,7329,32571,51971,OK
65.719,TraderOne,Tick,170,267,-97,97,146700,146900,7329,32571,51971,OK
66.016,TraderOne,Tick,178,267,-89,89,146600,146900,7212,32688,50488,OK
66.235,TraderOne,Tick,178,267,-89,89,146600,146900,7212,32688,50488,OK
66.563,TraderOne,Tick,178,277,-99,99,147300,146900,7065,34835,15035,OK
66.766,TraderOne,Tick,178,277,-99,99,146500,146900,7065,34835,54635,OK
67.016,TraderOne,Tick,178,277,-99,99,146500,146900,7065,34835,54635,OK
67.25,TraderOne,Tick,178,277,-99,99,146500,146900,7065,34835,54635,OK
67.453,TraderOne,Tick,178,277,-99,99,146500,146900,7065,34835,54635,OK
67.719,TraderOne,Tick,178,277,-99,99,146500,146900,7065,34835,54635,OK
68.016,TraderOne,Tick,178,277,-99,99,146500,146900,7065,34835,54635,OK
68.203,TraderOne,Tick,178,277,-99,99,146900,146900,7065,34835,34835,OK
68.516,TraderOne,Tick,188,277,-89,89,146500,146900,6918,34982,52782,OK
68.766,TraderOne,Tick,188,277,-89,89,146500,147200,6918,34982,52782,OK
69.016,TraderOne,Tick,188,277,-89,89,146500,147200,6918,34982,52782,OK
69.25,TraderOne,Tick,188,287,-99,99,147500,147200,6771,35129,15329,OK
69.453,TraderOne,Tick,188,287,-99,99,147500,147200,6771,35129,15329,OK
69.735,TraderOne,Tick,188,287,-99,99,147500,147300,6771,35129,15329,OK
70.0,TraderOne,Tick,188,287,-99,99,147500,147300,6771,35129,15329,OK
70.235,TraderOne,Tick,188,287,-99,99,147500,147300,6771,35129,15329,OK
70.469,TraderOne,Tick,188,287,-99,99,147500,147300,6771,35129,15329,OK
70.75,TraderOne,Tick,198,287,-89,89,146500,147300,6624,36276,54076,OK
71.032,TraderOne,Tick,198,287,-89,89,146500,147300,6624,36276,54076,OK
71.203,TraderOne,Tick,198,287,-89,89,146500,147300,6624,36276,54076,OK
71.469,TraderOne,Tick,198,287,-89,89,146500,147300,6624,36276,54076,OK
71.75,TraderOne,Tick,198,287,-89,89,146500,147300,6624,36276,54076,OK
72.0,TraderOne,Tick,198,287,-89,89,146500,147300,6624,36276,54076,OK
72.297,TraderOne,Tick,198,287,-89,89,146500,147300,6624,36276,54076,OK
72.469,TraderOne,Tick,198,287,-89,89,147500,147300,6624,36276,18476,OK
72.75,TraderOne,Tick,198,297,-99,99,147500,147300,6919,36981,17181,OK
72.985,TraderOne,Tick,198,297,-99,99,147600,147300,6919,36981,17181,OK
73.266,TraderOne,Tick,198,297,-99,99,147600,147300,6919,36981,17181,OK
73.485,TraderOne,Tick,198,297,-99,99,147600,147200,6919,36981,17181,OK
73.766,TraderOne,Tick,198,297,-99,99,147600,147200,6919,36981,17181,OK
73.969,TraderOne,Tick,198,297,-99,99,147600,147200,6919,36981,17181,OK
74.282,TraderOne,Tick,198,297,-99,99,147600,147200,6919,36981,17181,OK
74.532,TraderOne,Tick,198,297,-99,99,147600,147200,6919,36981,17181,OK
74.782,TraderOne,Tick,198,297,-99,99,147600,147200,6919,36981,17181,OK
75.032,TraderOne,Tick,198,297,-99,99,147600,147200,6919,36981,17181,OK
75.266,TraderOne,Tick,198,297,-99,99,147600,147400,6919,36981,17181,OK
75.516,TraderOne,Tick,198,297,-99,99,147600,147400,6919,36981,17181,OK
75.719,TraderOne,Tick,198,297,-99,99,147600,147400,6919,36981,17181,OK
75.985,TraderOne,Tick,198,297,-99,99,147600,147400,6919,36981,17181,OK
76.266,TraderOne,Tick,198,297,-99,99,147600,147400,6919,36981,17181,OK
76.485,TraderOne,Tick,198,297,-99,99,147600,147500,6919,36981,27081,OK
76.797,TraderOne,Tick,198,297,-99,99,147600,147600,6919,36981,36981,OK
77.016,TraderOne,Tick,198,297,-99,99,147600,147600,6919,36981,36981,OK
77.297,TraderOne,Tick,198,297,-99,99,147600,147600,6919,36981,36981,OK
77.547,TraderOne,Tick,198,297,-99,99,147600,147600,6919,36981,36981,OK
77.797,TraderOne,Tick,198,297,-99,99,147500,147600,6919,36981,46881,OK
78.0,TraderOne,Tick,198,297,-99,99,147500,147600,6919,36981,46881,OK
78.203,TraderOne,Tick,198,297,-99,99,147500,147600,6919,36981,46881,OK
78.5,TraderOne,Tick,198,297,-99,99,147500,147600,6919,36981,46881,OK
78.719,TraderOne,Tick,198,297,-99,99,147500,147600,6919,36981,46881,OK
79.032,TraderOne,Tick,198,297,-99,99,147500,147600,6919,36981,46881,OK
79.203,TraderOne,Tick,198,297,-99,99,147500,147600,6919,36981,46881,OK
79.547,TraderOne,Tick,198,297,-99,99,147500,147600,6919,36981,46881,OK
79.719,TraderOne,Tick,208,297,-89,89,147600,148200,7214,41686,59486,OK
80.047,TraderOne,Tick,208,297,-89,89,147600,148400,7214,41686,59486,OK
80.25,TraderOne,Tick,218,297,-79,79,147900,148400,7510,44390,60190,OK
80.547,TraderOne,Tick,218,297,-79,79,147900,148400,7510,44390,60190,OK
80.766,TraderOne,Tick,228,297,-69,69,147900,148400,7806,47094,60894,OK
81.047,TraderOne,Tick,228,297,-69,69,147900,148400,7806,47094,60894,OK
81.25,TraderOne,Tick,228,297,-69,69,147900,148200,7806,47094,60894,OK
81.5,TraderOne,Tick,238,297,-59,59,147900,148400,8102,48798,60598,OK
81.75,TraderOne,Tick,248,297,-49,49,148100,148400,8398,52502,62302,OK
82.0,TraderOne,Tick,258,297,-39,39,148000,148400,8694,56206,64006,OK
82.235,TraderOne,Tick,268,297,-29,29,148100,148400,8990,59910,65710,OK
82.563,TraderOne,Tick,278,297,-19,19,148200,148800,9286,64614,68414,OK
82.766,TraderOne,Tick,288,297,-9,9,148400,148800,9582,67818,69618,OK
83.0,TraderOne,Tick,298,297,1,-1,148400,148800,9879,69521,69321,OK
83.282,TraderOne,Tick,308,297,11,-11,148400,148800,10176,72224,70024,OK
83.5,TraderOne,Tick,308,297,11,-11,148400,148800,10176,72224,70024,OK
83.75,TraderOne,Tick,308,297,11,-11,148400,148800,10176,72224,70024,OK
84.0,TraderOne,Tick,318,297,21,-21,148400,149000,10473,75927,71727,OK
84.266,TraderOne,Tick,318,297,21,-21,148400,149000,10473,75927,71727,OK
84.563,TraderOne,Tick,328,297,31,-31,148500,149000,10770,79630,73430,OK
84.719,TraderOne,Tick,338,297,41,-41,148600,149200,11067,85933,77733,OK
84.953,TraderOne,Tick,338,297,41,-41,148600,149200,11067,85933,77733,OK
85.219,TraderOne,Tick,348,297,51,-51,148800,149200,11365,87635,77435,OK
85.516,TraderOne,Tick,348,297,51,-51,148800,149200,11365,87635,77435,OK
85.766,TraderOne,Tick,348,297,51,-51,148800,149200,11365,87635,77435,OK
86.063,TraderOne,Tick,348,297,51,-51,148900,149600,11365,87635,77435,OK
86.266,TraderOne,Tick,358,297,61,-61,149300,149600,11664,89336,77136,OK
86.516,TraderOne,Tick,368,297,71,-71,149300,149600,11963,92037,77837,OK
86.75,TraderOne,Tick,378,297,81,-81,149600,149600,12262,91738,91738,OK
87.032,TraderOne,Tick,378,297,81,-81,149600,149600,12262,91738,91738,OK
87.219,TraderOne,Tick,388,297,91,-91,149600,149600,12561,91439,91439,OK
87.516,TraderOne,Tick,388,297,91,-91,149600,149700,12561,91439,82339,OK
87.703,TraderOne,Tick,388,297,91,-91,149600,149700,12561,91439,82339,OK
88.016,TraderOne,Tick,388,297,91,-91,149600,149500,12561,91439,100539,OK
88.219,TraderOne,Tick,388,297,91,-91,149600,149500,12561,91439,100539,OK
88.516,TraderOne,Tick,388,297,91,-91,149600,149200,12561,91439,109639,OK
88.766,TraderOne,Tick,388,297,91,-91,149600,149100,12561,91439,109639,OK
89.0,TraderOne,Tick,388,297,91,-91,149600,149100,12561,91439,109639,OK
89.219,TraderOne,Tick,388,297,91,-91,149600,149100,12561,91439,109639,OK
89.516,TraderOne,Tick,388,297,91,-91,149600,148900,12561,91439,109639,OK
89.719,TraderOne,Tick,388,297,91,-91,149600,148900,12561,91439,109639,OK
90.0,TraderOne,Tick,388,297,91,-91,149600,148900,12561,91439,109639,OK
90.282,TraderOne,Tick,388,297,91,-91,149600,149100,12561,91439,109639,OK
90.485,TraderOne,Tick,388,297,91,-91,149600,149100,12561,91439,109639,OK
90.719,TraderOne,Tick,388,297,91,-91,149600,149100,12561,91439,109639,OK
90.953,TraderOne,Tick,388,307,81,-81,149100,149100,12412,91588,91588,OK
91.25,TraderOne,Tick,388,317,71,-71,149400,149100,12711,94289,108489,OK
91.547,TraderOne,Tick,388,317,71,-71,149400,148900,12711,94289,108489,OK
91.75,TraderOne,Tick,388,327,61,-61,149600,148900,12786,95714,107914,OK
91.953,TraderOne,Tick,388,331,57,-57,149500,148900,12906,97194,108594,OK
92.219,TraderOne,Tick,398,331,67,-67,148500,148900,12757,98343,84943,OK
92.5,TraderOne,Tick,398,331,67,-67,148500,148900,12757,98343,84943,OK
92.766,TraderOne,Tick,398,331,67,-67,148500,148900,12757,98343,84943,OK
93.047,TraderOne,Tick,398,331,67,-67,148500,149200,12757,98343,84943,OK
93.25,TraderOne,Tick,398,331,67,-67,148500,149200,12757,98343,84943,OK
93.547,TraderOne,Tick,398,331,67,-67,148500,149200,12757,98343,84943,OK
93.75,TraderOne,Tick,398,331,67,-67,148500,149200,12757,98343,84943,OK
94.0,TraderOne,Tick,398,331,67,-67,148500,149200,12757,98343,84943,OK
94.266,TraderOne,Tick,398,331,67,-67,148500,149200,12757,98343,84943,OK
94.547,TraderOne,Tick,398,331,67,-67,148500,149200,12757,98343,84943,OK
94.766,TraderOne,Tick,398,331,67,-67,148500,149200,12757,98343,84943,OK
95.0,TraderOne,Tick,398,331,67,-67,148500,149200,12757,98343,84943,OK
95.203,TraderOne,Tick,398,331,67,-67,148500,149200,12757,98343,84943,OK
95.516,TraderOne,Tick,398,331,67,-67,148500,149200,12757,98343,84943,OK
95.719,TraderOne,Tick,398,331,67,-67,148500,149200,12757,98343,84943,OK
96.0,TraderOne,Tick,398,331,67,-67,148500,149200,12757,98343,84943,OK
96.25,TraderOne,Tick,398,331,67,-67,148500,149200,12757,98343,84943,OK
96.453,TraderOne,Tick,398,331,67,-67,148500,149200,12757,98343,84943,OK
96.75,TraderOne,Tick,398,331,67,-67,148500,149200,12757,98343,84943,OK
96.969,TraderOne,Tick,398,331,67,-67,148500,149200,12757,98343,84943,OK
97.282,TraderOne,Tick,398,331,67,-67,148500,149200,12757,98343,84943,OK
97.516,TraderOne,Tick,408,331,77,-77,149800,149600,12607,98493,113893,OK
97.813,TraderOne,Tick,408,331,77,-77,149800,149900,12607,98493,90793,OK
98.016,TraderOne,Tick,408,331,77,-77,149800,149800,12607,98493,98493,OK
98.203,TraderOne,Tick,408,331,77,-77,149800,149800,12607,98493,98493,OK
98.469,TraderOne,Tick,408,331,77,-77,149200,149800,12607,98493,75393,OK
98.797,TraderOne,Tick,408,331,77,-77,149800,149800,12607,98493,98493,OK
98.985,TraderOne,Tick,408,331,77,-77,149800,149900,12607,98493,90793,OK
99.297,TraderOne,Tick,418,331,87,-87,149800,150100,12907,99193,73093,OK
99.516,TraderOne,Tick,428,331,97,-97,149900,150000,13207,100893,91193,OK
99.782,TraderOne,Tick,428,331,97,-97,149900,150000,13207,100893,91193,OK
100.0,TraderOne,Tick,428,331,97,-97,149900,150000,13207,100893,91193,OK
100.266,TraderOne,Tick,428,331,97,-97,149900,149900,13207,100893,100893,OK
100.532,TraderOne,Tick,428,331,97,-97,149900,149900,13207,100893,100893,OK
100.766,TraderOne,Tick,428,331,97,-97,149900,149900,13207,100893,100893,OK
101.016,TraderOne,Tick,428,331,97,-97,149900,149900,13207,100893,100893,OK
101.266,TraderOne,Tick,428,331,97,-97,149400,149900,13207,100893,71793,OK
101.547,TraderOne,Tick,428,331,97,-97,149400,150100,13207,100893,71793,OK
101.782,TraderOne,Tick,428,331,97,-97,149400,150100,13207,100893,71793,OK
102.047,TraderOne,Tick,428,331,97,-97,149400,150100,13207,100893,71793,OK
102.297,TraderOne,Tick,428,331,97,-97,149400,150100,13207,100893,71793,OK
102.453,TraderOne,Tick,428,331,97,-97,149400,150100,13207,100893,71793,OK
102.782,TraderOne,Tick,428,331,97,-97,149400,150300,13207,100893,71793,OK
102.985,TraderOne,Tick,428,331,97,-97,149400,150300,13207,100893,71793,OK
103.25,TraderOne,Tick,428,331,97,-97,149400,150300,13207,100893,71793,OK
103.5,TraderOne,Tick,428,331,97,-97,149900,150300,13207,100893,71793,OK
103.719,TraderOne,Tick,428,331,97,-97,149900,150300,13207,100893,71793,OK
103.953,TraderOne,Tick,428,331,97,-97,149900,150400,13207,100893,71793,OK
104.266,TraderOne,Tick,428,331,97,-97,149900,150200,13207,100893,71793,OK
104.5,TraderOne,Tick,428,331,97,-97,149900,150200,13207,100893,71793,OK
104.766,TraderOne,Tick,428,331,97,-97,149900,150200,13207,100893,71793,OK
105.0,TraderOne,Tick,428,331,97,-97,149900,150200,13207,100893,71793,OK
105.25,TraderOne,Tick,428,331,97,-97,149900,150200,13207,100893,71793,OK
105.485,TraderOne,Tick,428,331,97,-97,149900,150200,13207,100893,71793,OK
105.75,TraderOne,Tick,428,331,97,-97,149900,150200,13207,100893,71793,OK
106.0,TraderOne,Tick,428,331,97,-97,149900,150300,13207,100893,71793,OK
106.203,TraderOne,Tick,428,331,97,-97,149900,150500,13207,100893,71793,OK
106.5,TraderOne,Tick,428,331,97,-97,150200,150500,13207,100893,71793,OK
106.719,TraderOne,Tick,428,331,97,-97,150200,150400,13207,100893,81493,OK
107.032,TraderOne,Tick,428,331,97,-97,150200,150300,13207,100893,91193,OK
107.219,TraderOne,Tick,428,331,97,-97,150200,150300,13207,100893,91193,OK
107.5,TraderOne,Tick,428,331,97,-97,150200,150400,13207,100893,81493,OK
107.782,TraderOne,Tick,428,331,97,-97,150200,150400,13207,100893,81493,OK
108.032,TraderOne,Tick,428,331,97,-97,150200,150400,13207,100893,81493,OK
108.266,TraderOne,Tick,428,331,97,-97,150200,150300,13207,100893,91193,OK
108.453,TraderOne,Tick,428,331,97,-97,150200,150100,13207,100893,110593,OK
108.75,TraderOne,Tick,428,331,97,-97,150200,150100,13207,100893,110593,OK
109.047,TraderOne,Tick,428,331,97,-97,149600,150100,13207,100893,71793,OK
109.25,TraderOne,Tick,428,331,97,-97,149600,150100,13207,100893,71793,OK
109.469,TraderOne,Tick,428,331,97,-97,149600,150100,13207,100893,71793,OK
109.75,TraderOne,Tick,428,331,97,-97,149600,150100,13207,100893,71793,OK
110.032,TraderOne,Tick,428,331,97,-97,149600,150100,13207,100893,71793,OK
110.266,TraderOne,Tick,428,331,97,-97,150200,150500,13207,100893,71793,OK
110.469,TraderOne,Tick,428,331,97,-97,150200,150500,13207,100893,71793,OK
110.782,TraderOne,Tick,428,331,97,-97,150200,150700,13207,100893,71793,OK
110.969,TraderOne,Tick,428,331,97,-97,150200,150600,13207,100893,71793,OK
111.282,TraderOne,Tick,428,331,97,-97,150200,150600,13207,100893,71793,OK
111.453,TraderOne,Tick,428,331,97,-97,150200,150600,13207,100893,71793,OK
111.797,TraderOne,Tick,428,331,97,-97,150100,150600,13207,100893,71793,OK
112.032,TraderOne,Tick,428,331,97,-97,150100,150600,13207,100893,71793,OK
112.219,TraderOne,Tick,428,331,97,-97,150100,150500,13207,100893,71793,OK
112.469,TraderOne,Tick,428,331,97,-97,150100,150400,13207,100893,71793,OK
112.735,TraderOne,Tick,428,331,97,-97,150100,150500,13207,100893,71793,OK
112.969,TraderOne,Tick,428,331,97,-97,150100,150700,13207,100893,71793,OK
113.25,TraderOne,Tick,428,331,97,-97,150200,150600,13207,100893,71793,OK
113.485,TraderOne,Tick,428,331,97,-97,150200,150500,13207,100893,71793,OK
113.797,TraderOne,Tick,428,331,97,-97,150200,150500,13207,100893,71793,OK
113.969,TraderOne,Tick,428,331,97,-97,150200,150500,13207,100893,71793,OK
114.25,TraderOne,Tick,428,331,97,-97,150200,150600,13207,100893,71793,OK
114.453,TraderOne,Tick,428,331,97,-97,150500,150500,13207,100893,100893,OK
114.766,TraderOne,Tick,428,331,97,-97,150500,150500,13207,100893,100893,OK
115.032,TraderOne,Tick,428,331,97,-97,150500,150900,13207,100893,71793,OK
115.282,TraderOne,Tick,428,331,97,-97,150100,150500,13207,100893,71793,OK
115.469,TraderOne,Tick,428,331,97,-97,150100,150500,13207,100893,71793,OK
115.766,TraderOne,Tick,428,331,97,-97,150100,150500,13207,100893,71793,OK
116.016,TraderOne,Tick,428,331,97,-97,150100,150400,13207,100893,71793,OK
116.266,TraderOne,Tick,428,331,97,-97,150600,150500,13207,100893,110593,OK
116.453,TraderOne,Tick,428,331,97,-97,150600,150800,13207,100893,81493,OK
116.719,TraderOne,Tick,428,331,97,-97,150600,150800,13207,100893,81493,OK
117.016,TraderOne,Tick,428,331,97,-97,150000,150500,13207,100893,71793,OK
117.235,TraderOne,Tick,428,331,97,-97,150000,150500,13207,100893,71793,OK
117.516,TraderOne,Tick,428,331,97,-97,150000,150300,13207,100893,71793,OK
117.719,TraderOne,Tick,428,331,97,-97,150000,150300,13207,100893,71793,OK
118.047,TraderOne,Tick,428,331,97,-97,150000,150300,13207,100893,71793,OK
118.219,TraderOne,Tick,428,331,97,-97,150000,150300,13207,100893,71793,OK
118.5,TraderOne,Tick,428,331,97,-97,150000,150500,13207,100893,71793,OK
118.782,TraderOne,Tick,428,331,97,-97,150000,150300,13207,100893,71793,OK
119.0,TraderOne,Tick,428,331,97,-97,150500,150300,13207,100893,120293,OK
119.297,TraderOne,Tick,428,331,97,-97,150500,150300,13207,100893,120293,OK
119.547,TraderOne,Tick,428,331,97,-97,150500,150300,13207,100893,120293,OK
119.719,TraderOne,Tick,428,331,97,-97,150200,150100,13207,100893,110593,OK
120.016,TraderOne,Tick,428,331,97,-97,150200,150100,13207,100893,110593,OK
120.235,TraderOne,Tick,428,331,97,-97,150200,150600,13207,100893,71793,OK
120.516,TraderOne,Tick,428,331,97,-97,150200,150600,13207,100893,71793,OK
120.766,TraderOne,Tick,428,331,97,-97,150200,150600,13207,100893,71793,OK
121.016,TraderOne,Tick,428,331,97,-97,150200,150600,13207,100893,71793,OK
121.282,TraderOne,Tick,428,331,97,-97,150000,150600,13207,100893,71793,OK
121.547,TraderOne,Tick,428,331,97,-97,150000,150600,13207,100893,71793,OK
121.766,TraderOne,Tick,428,331,97,-97,150000,150600,13207,100893,71793,OK
122.016,TraderOne,Tick,428,331,97,-97,150000,150600,13207,100893,71793,OK
122.203,TraderOne,Tick,428,331,97,-97,150100,150600,13207,100893,71793,OK
122.516,TraderOne,Tick,428,331,97,-97,150100,150500,13207,100893,71793,OK
122.75,TraderOne,Tick,428,331,97,-97,150100,150500,13207,100893,71793,OK
123.0,TraderOne,Tick,428,331,97,-97,150100,150500,13207,100893,71793,OK
123.25,TraderOne,Tick,428,331,97,-97,150100,150400,13207,100893,71793,OK
123.453,TraderOne,Tick,428,331,97,-97,150100,150400,13207,100893,71793,OK
123.766,TraderOne,Tick,428,331,97,-97,150400,150400,13207,100893,100893,OK
124.047,TraderOne,Tick,428,331,97,-97,150400,150400,13207,100893,100893,OK
124.297,TraderOne,Tick,428,331,97,-97,150600,150400,13207,100893,120293,OK
124.532,TraderOne,Tick,428,331,97,-97,150600,150400,13207,100893,120293,OK
124.766,TraderOne,Tick,428,331,97,-97,150600,150400,13207,100893,120293,OK
125.047,TraderOne,Tick,428,331,97,-97,150600,150400,13207,100893,120293,OK
125.266,TraderOne,Tick,428,331,97,-97,150600,150400,13207,100893,120293,OK
125.547,TraderOne,Tick,428,331,97,-97,150400,150400,13207,100893,100893,OK
125.782,TraderOne,Tick,428,331,97,-97,150400,150400,13207,100893,100893,OK
126.016,TraderOne,Tick,428,331,97,-97,150400,150700,13207,100893,71793,OK
126.282,TraderOne,Tick,428,331,97,-97,150400,151100,13207,100893,71793,OK
126.5,TraderOne,Tick,428,331,97,-97,150500,151200,13207,100893,71793,OK
126.703,TraderOne,Tick,428,331,97,-97,150500,151000,13207,100893,71793,OK
127.0,TraderOne,Tick,428,331,97,-97,150500,151000,13207,100893,71793,OK
127.266,TraderOne,Tick,428,331,97,-97,150500,151000,13207,100893,71793,OK
127.453,TraderOne,Tick,428,331,97,-97,150500,150700,13207,100893,81493,OK
127.719,TraderOne,Tick,428,331,97,-97,150500,150500,13207,100893,100893,OK
128.0,TraderOne,Tick,428,331,97,-97,150700,150300,13207,100893,129993,OK
128.203,TraderOne,Tick,428,331,97,-97,150700,150300,13207,100893,129993,OK
128.5,TraderOne,Tick,428,331,97,-97,150700,150200,13207,100893,129993,OK
128.703,TraderOne,Tick,428,331,97,-97,150700,150200,13207,100893,129993,OK
129.0,TraderOne,Tick,428,331,97,-97,150700,150200,13207,100893,129993,OK
129.25,TraderOne,Tick,428,331,97,-97,150700,150200,13207,100893,129993,OK
129.516,TraderOne,Tick,428,341,87,-87,151000,150400,13056,102044,128144,OK
129.75,TraderOne,Tick,428,341,87,-87,151000,150400,13056,102044,128144,OK
129.969,TraderOne,Tick,428,341,87,-87,151000,150400,13056,102044,128144,OK
130.25,TraderOne,Tick,428,341,87,-87,151000,150400,13056,102044,128144,OK
130.532,TraderOne,Tick,428,341,87,-87,151000,150400,13056,102044,128144,OK
130.797,TraderOne,Tick,428,341,87,-87,151000,150400,13056,102044,128144,OK
131.0,TraderOne,Tick,428,341,87,-87,151000,150400,13056,102044,128144,OK
131.282,TraderOne,Tick,428,342,86,-86,150400,150100,13086,102114,127914,OK
131.5,TraderOne,Tick,428,342,86,-86,150400,150100,13086,102114,127914,OK
131.766,TraderOne,Tick,428,342,86,-86,150400,150100,13086,102114,127914,OK
132.0,TraderOne,Tick,428,342,86,-86,150800,150100,13086,102114,127914,OK
132.25,TraderOne,Tick,428,342,86,-86,150800,149800,13086,102114,127914,OK
132.453,TraderOne,Tick,428,342,86,-86,150800,149800,13086,102114,127914,OK
132.735,TraderOne,Tick,428,342,86,-86,150800,149600,13086,102114,119314,OK
133.032,TraderOne,Tick,428,352,76,-76,149900,149600,13386,104814,120014,OK
133.235,TraderOne,Tick,428,362,66,-66,150200,149600,13686,105514,118714,OK
133.516,TraderOne,Tick,428,362,66,-66,150200,149600,13686,105514,118714,OK
133.719,TraderOne,Tick,428,362,66,-66,149600,149500,13686,105514,112114,OK
133.969,TraderOne,Tick,428,362,66,-66,149600,149600,13686,105514,105514,OK
134.219,TraderOne,Tick,428,362,66,-66,149600,149600,13686,105514,105514,OK
134.469,TraderOne,Tick,428,362,66,-66,149600,149700,13686,105514,98914,OK
134.797,TraderOne,Tick,428,362,66,-66,149600,149700,13686,105514,98914,OK
134.985,TraderOne,Tick,428,362,66,-66,149600,149800,13686,105514,92314,OK
135.266,TraderOne,Tick,428,362,66,-66,149200,149800,13686,105514,85714,OK
135.516,TraderOne,Tick,438,364,74,-74,149300,149900,13596,108404,86204,OK
135.719,TraderOne,Tick,438,364,74,-74,149300,149900,13596,108404,86204,OK
135.953,TraderOne,Tick,438,364,74,-74,149300,149900,13596,108404,86204,OK
136.297,TraderOne,Tick,438,364,74,-74,149300,149900,13596,108404,86204,OK
136.485,TraderOne,Tick,438,364,74,-74,149300,149900,13596,108404,86204,OK
136.75,TraderOne,Tick,438,364,74,-74,149300,149800,13596,108404,86204,OK
137.016,TraderOne,Tick,438,364,74,-74,149300,149600,13596,108404,93604,OK
137.219,TraderOne,Tick,438,364,74,-74,149300,149600,13596,108404,93604,OK
137.532,TraderOne,Tick,438,364,74,-74,149300,149600,13596,108404,93604,OK
137.75,TraderOne,Tick,438,364,74,-74,149300,149300,13596,108404,108404,OK
138.047,TraderOne,Tick,438,364,74,-74,149300,149300,13596,108404,108404,OK
138.282,TraderOne,Tick,438,364,74,-74,149300,149300,13596,108404,108404,OK
138.5,TraderOne,Tick,438,364,74,-74,149300,149300,13596,108404,108404,OK
138.719,TraderOne,Tick,438,364,74,-74,149300,149100,13596,108404,123204,OK
138.969,TraderOne,Tick,438,364,74,-74,149300,149100,13596,108404,123204,OK
139.219,TraderOne,Tick,438,364,74,-74,149300,149100,13596,108404,123204,OK
139.469,TraderOne,Tick,438,364,74,-74,149300,149300,13596,108404,108404,OK
139.703,TraderOne,Tick,438,364,74,-74,149300,149300,13596,108404,108404,OK
140.032,TraderOne,Tick,438,364,74,-74,149300,149300,13596,108404,108404,OK
140.235,TraderOne,Tick,438,364,74,-74,149300,149300,13596,108404,108404,OK
140.516,TraderOne,Tick,438,371,67,-67,149700,149300,13491,107809,121209,OK
140.719,TraderOne,Tick,438,371,67,-67,149700,149300,13491,107809,121209,OK
141.0,TraderOne,Tick,438,371,67,-67,149700,149300,13491,107809,121209,OK
141.297,TraderOne,Tick,438,371,67,-67,149700,149300,13491,107809,121209,OK
141.547,TraderOne,Tick,438,371,67,-67,149700,149300,13491,107809,121209,OK
141.75,TraderOne,Tick,438,371,67,-67,150200,149500,13491,107809,121209,OK
142.032,TraderOne,Tick,438,371,67,-67,150200,149500,13491,107809,121209,OK
142.188,TraderOne,Tick,438,371,67,-67,150200,149500,13491,107809,121209,OK
142.532,TraderOne,Tick,438,371,67,-67,150200,149500,13491,107809,121209,OK
142.75,TraderOne,Tick,438,381,57,-57,150200,149500,13341,107959,119359,OK
143.0,TraderOne,Tick,438,381,57,-57,150200,149500,13341,107959,119359,OK
143.235,TraderOne,Tick,438,381,57,-57,150200,149500,13341,107959,119359,OK
143.532,TraderOne,Tick,438,381,57,-57,150200,149700,13341,107959,119359,OK
143.703,TraderOne,Tick,438,381,57,-57,150200,149700,13341,107959,119359,OK
144.0,TraderOne,Tick,448,381,67,-67,149200,149700,13191,109109,95709,OK
144.266,TraderOne,Tick,448,381,67,-67,149200,149700,13191,109109,95709,OK
144.453,TraderOne,Tick,458,381,77,-77,149100,149700,13041,109259,93859,OK
144.782,TraderOne,Tick,458,381,77,-77,149100,149700,13041,109259,93859,OK
145.0,TraderOne,Tick,458,381,77,-77,149100,149700,13041,109259,93859,OK
145.203,TraderOne,Tick,458,381,77,-77,149100,149700,13041,109259,93859,OK
145.485,TraderOne,Tick,458,381,77,-77,149100,149700,13041,109259,93859,OK
145.782,TraderOne,Tick,458,381,77,-77,149100,149700,13041,109259,93859,OK
145.985,TraderOne,Tick,458,381,77,-77,149100,149700,13041,109259,93859,OK
146.282,TraderOne,Tick,458,381,77,-77,149100,149500,13041,109259,93859,OK
146.516,TraderOne,Tick,458,381,77,-77,149100,149500,13041,109259,93859,OK
146.719,TraderOne,Tick,458,381,77,-77,149100,149700,13041,109259,93859,OK
146.969,TraderOne,Tick,458,381,77,-77,149100,149700,13041,109259,93859,OK
147.219,TraderOne,Tick,458,381,77,-77,149100,149700,13041,109259,93859,OK
147.5,TraderOne,Tick,458,381,77,-77,149100,149600,13041,109259,93859,OK
147.782,TraderOne,Tick,458,381,77,-77,149100,149600,13041,109259,93859,OK
147.985,TraderOne,Tick,458,381,77,-77,149100,149600,13041,109259,93859,OK
148.25,TraderOne,Tick,458,381,77,-77,149100,149600,13041,109259,93859,OK
148.532,TraderOne,Tick,458,381,77,-77,149100,149600,13041,109259,93859,OK
148.703,TraderOne,Tick,458,381,77,-77,149100,149600,13041,109259,93859,OK
149.0,TraderOne,Tick,458,381,77,-77,149100,149600,13041,109259,93859,OK
149.219,TraderOne,Tick,458,381,77,-77,149100,149600,13041,109259,93859,OK
149.547,TraderOne,Tick,458,391,67,-67,150600,150100,12891,111409,131509,OK
149.75,TraderOne,Tick,458,391,67,-67,150600,150100,12891,111409,131509,OK
150.0,TraderOne,Tick,458,391,67,-67,150600,150100,12891,111409,131509,OK
150.25,TraderOne,Tick,458,391,67,-67,150600,150100,12891,111409,131509,OK
150.547,TraderOne,Tick,458,400,58,-58,149900,150100,13161,112739,101139,OK
150.766,TraderOne,Tick,458,400,58,-58,149900,150100,13161,112739,101139,OK
150.953,TraderOne,Tick,458,400,58,-58,149900,150100,13161,112739,101139,OK
151.266,TraderOne,Tick,458,400,58,-58,149900,150100,13161,112739,101139,OK
151.563,TraderOne,Tick,458,400,58,-58,149900,150100,13161,112739,101139,OK
151.766,TraderOne,Tick,458,400,58,-58,149900,150100,13161,112739,101139,OK
152.016,TraderOne,Tick,458,400,58,-58,149900,150100,13161,112739,101139,OK
152.235,TraderOne,Tick,458,400,58,-58,149900,150100,13161,112739,101139,OK
152.485,TraderOne,Tick,458,400,58,-58,149900,150100,13161,112739,101139,OK
152.782,TraderOne,Tick,458,400,58,-58,149900,150100,13161,112739,101139,OK
152.969,TraderOne,Tick,458,400,58,-58,150400,150100,13161,112739,130139,OK
153.266,TraderOne,Tick,458,400,58,-58,150400,149800,13161,112739,130139,OK
153.453,TraderOne,Tick,458,400,58,-58,150400,149800,13161,112739,130139,OK
153.75,TraderOne,Tick,458,400,58,-58,150400,150100,13161,112739,130139,OK
154.047,TraderOne,Tick,458,400,58,-58,150400,150100,13161,112739,130139,OK
154.266,TraderOne,Tick,458,400,58,-58,150400,150100,13161,112739,130139,OK
154.5,TraderOne,Tick,458,400,58,-58,150400,150100,13161,112739,130139,OK
154.782,TraderOne,Tick,458,400,58,-58,150400,150100,13161,112739,130139,OK
154.953,TraderOne,Tick,458,400,58,-58,150400,150100,13161,112739,130139,OK
155.25,TraderOne,Tick,458,400,58,-58,150400,150100,13161,112739,130139,OK
155.516,TraderOne,Tick,458,400,58,-58,150400,150300,13161,112739,118539,OK
155.719,TraderOne,Tick,458,400,58,-58,150400,150300,13161,112739,118539,OK
156.0,TraderOne,Tick,458,400,58,-58,150400,150300,13161,112739,118539,OK
156.25,TraderOne,Tick,458,400,58,-58,150400,150300,13161,112739,118539,OK
156.547,TraderOne,Tick,458,400,58,-58,150400,150300,13161,112739,118539,OK
156.719,TraderOne,Tick,458,400,58,-58,150400,150300,13161,112739,118539,OK
157.0,TraderOne,Tick,458,400,58,-58,150400,150300,13161,112739,118539,OK
157.235,TraderOne,Tick,458,400,58,-58,150600,150300,13161,112739,130139,OK
157.453,TraderOne,Tick,458,400,58,-58,150600,150300,13161,112739,130139,OK
157.766,TraderOne,Tick,458,400,58,-58,150600,150300,13161,112739,130139,OK
158.0,TraderOne,Tick,458,410,48,-48,150500,150300,13011,113889,123489,OK
158.235,TraderOne,Tick,458,410,48,-48,150500,150300,13011,113889,123489,OK
158.5,TraderOne,Tick,458,420,38,-38,150500,150300,13312,114588,122188,OK
158.766,TraderOne,Tick,460,420,40,-40,150200,150300,13372,114728,110728,OK
158.969,TraderOne,Tick,460,420,40,-40,150200,150400,13372,114728,106728,OK
159.203,TraderOne,Tick,460,420,40,-40,150600,150400,13372,114728,122728,OK
159.516,TraderOne,Tick,460,420,40,-40,150600,150400,13372,114728,122728,OK
159.813,TraderOne,Tick,460,420,40,-40,150600,150400,13372,114728,122728,OK
159.969,TraderOne,Tick,460,420,40,-40,150600,150400,13372,114728,122728,OK
160.203,TraderOne,Tick,460,420,40,-40,150600,150400,13372,114728,122728,OK
160.485,TraderOne,Tick,460,420,40,-40,150600,150400,13372,114728,122728,OK
160.719,TraderOne,Tick,460,420,40,-40,150600,150200,13372,114728,126728,OK
161.0,TraderOne,Tick,460,420,40,-40,150600,150200,13372,114728,126728,OK
161.25,TraderOne,Tick,460,420,40,-40,150600,150200,13372,114728,126728,OK
161.516,TraderOne,Tick,460,420,40,-40,150600,150200,13372,114728,126728,OK
161.735,TraderOne,Tick,460,420,40,-40,150600,150200,13372,114728,126728,OK
162.0,TraderOne,Tick,460,420,40,-40,150600,150200,13372,114728,126728,OK
162.25,TraderOne,Tick,460,420,40,-40,150600,150700,13372,114728,110728,OK
162.532,TraderOne,Tick,460,420,40,-40,150800,150800,13372,114728,114728,OK
162.766,TraderOne,Tick,460,420,40,-40,150800,150800,13372,114728,114728,OK
163.032,TraderOne,Tick,460,420,40,-40,150800,150700,13372,114728,118728,OK
163.266,TraderOne,Tick,460,420,40,-40,150800,150800,13372,114728,114728,OK
163.453,TraderOne,Tick,460,420,40,-40,150800,150800,13372,114728,114728,OK
163.75,TraderOne,Tick,460,420,40,-40,150800,150800,13372,114728,114728,OK
164.016,TraderOne,Tick,470,420,50,-50,150700,150800,13673,115427,110427,OK
164.297,TraderOne,Tick,470,420,50,-50,150700,151000,13673,115427,100427,OK
164.485,TraderOne,Tick,470,420,50,-50,150700,151000,13673,115427,100427,OK
164.719,TraderOne,Tick,470,420,50,-50,150800,150900,13673,115427,110427,OK
165.032,TraderOne,Tick,473,420,53,-53,150800,151000,13763,115337,104737,OK
165.266,TraderOne,Tick,473,420,53,-53,150800,151000,13763,115337,104737,OK
165.453,TraderOne,Tick,473,430,43,-43,151300,151000,13612,117488,130388,OK
165.766,TraderOne,Tick,473,430,43,-43,151300,151000,13612,117488,130388,OK
165.953,TraderOne,Tick,473,430,43,-43,151300,151000,13612,117488,130388,OK
166.219,TraderOne,Tick,473,430,43,-43,151300,151100,13612,117488,126088,OK
166.453,TraderOne,Tick,473,430,43,-43,151300,151100,13612,117488,126088,OK
166.797,TraderOne,Tick,473,430,43,-43,151300,151100,13612,117488,126088,OK
167.032,TraderOne,Tick,473,430,43,-43,151300,151100,13612,117488,126088,OK
167.313,TraderOne,Tick,473,430,43,-43,151300,151100,13612,117488,126088,OK
167.516,TraderOne,Tick,473,430,43,-43,151300,151100,13612,117488,126088,OK
167.75,TraderOne,Tick,473,430,43,-43,151400,151100,13612,117488,130388,OK
167.953,TraderOne,Tick,473,430,43,-43,151400,151100,13612,117488,130388,OK
168.266,TraderOne,Tick,473,430,43,-43,151400,151100,13612,117488,130388,OK
168.485,TraderOne,Tick,473,430,43,-43,151400,151100,13612,117488,130388,OK
168.719,TraderOne,Tick,473,430,43,-43,151400,151100,13612,117488,130388,OK
168.953,TraderOne,Tick,473,430,43,-43,151400,151100,13612,117488,130388,OK
169.219,TraderOne,Tick,473,440,33,-33,151100,150500,13461,119639,129539,OK
169.516,TraderOne,Tick,473,440,33,-33,151100,150500,13461,119639,129539,OK
169.766,TraderOne,Tick,473,440,33,-33,151100,150800,13461,119639,129539,OK
169.953,TraderOne,Tick,473,440,33,-33,151100,150700,13461,119639,129539,OK
170.266,TraderOne,Tick,473,440,33,-33,151100,150700,13461,119639,129539,OK
170.516,TraderOne,Tick,473,440,33,-33,151100,150700,13461,119639,129539,OK
170.766,TraderOne,Tick,473,440,33,-33,151100,150500,13461,119639,129539,OK
171.0,TraderOne,Tick,473,440,33,-33,151100,150500,13461,119639,129539,OK
171.266,TraderOne,Tick,473,440,33,-33,151100,150500,13461,119639,129539,OK
171.5,TraderOne,Tick,473,440,33,-33,150400,150500,13461,119639,116339,OK
171.735,TraderOne,Tick,473,440,33,-33,150400,150500,13461,119639,116339,OK
171.985,TraderOne,Tick,473,440,33,-33,151200,150500,13461,119639,129539,OK
172.266,TraderOne,Tick,473,440,33,-33,151200,150500,13461,119639,129539,OK
172.453,TraderOne,Tick,473,440,33,-33,151200,150500,13461,119639,129539,OK
172.782,TraderOne,Tick,473,440,33,-33,151000,150500,13461,119639,129539,OK
172.985,TraderOne,Tick,473,440,33,-33,151000,150500,13461,119639,129539,OK
173.297,TraderOne,Tick,473,440,33,-33,151000,150500,13461,119639,129539,OK
173.5,TraderOne,Tick,473,440,33,-33,151000,150500,13461,119639,129539,OK
173.75,TraderOne,Tick,473,440,33,-33,151000,150500,13461,119639,129539,OK
174.032,TraderOne,Tick,473,440,33,-33,151000,150500,13461,119639,129539,OK
174.297,TraderOne,Tick,473,440,33,-33,151000,150500,13461,119639,129539,OK
174.547,TraderOne,Tick,473,440,33,-33,151000,150500,13461,119639,129539,OK
174.703,TraderOne,Tick,473,440,33,-33,151000,150600,13461,119639,129539,OK
175.0,TraderOne,Tick,473,440,33,-33,151000,150600,13461,119639,129539,OK
175.235,TraderOne,Tick,473,440,33,-33,151000,150600,13461,119639,129539,OK
175.485,TraderOne,Tick,473,440,33,-33,150800,150600,13461,119639,126239,OK
175.797,TraderOne,Tick,473,440,33,-33,150800,150600,13461,119639,126239,OK
176.047,TraderOne,Tick,473,440,33,-33,150800,150600,13461,119639,126239,OK
176.297,TraderOne,Tick,473,440,33,-33,150800,150600,13461,119639,126239,OK
176.547,TraderOne,Tick,473,440,33,-33,150800,150600,13461,119639,126239,OK
176.688,TraderOne,Tick,473,440,33,-33,150800,150600,13461,119639,126239,OK
177.0,TraderOne,Tick,473,440,33,-33,150800,150600,13461,119639,126239,OK
177.266,TraderOne,Tick,473,440,33,-33,150800,150600,13461,119639,126239,OK
177.547,TraderOne,Tick,473,440,33,-33,151200,150600,13461,119639,129539,OK
177.735,TraderOne,Tick,473,440,33,-33,151200,150300,13461,119639,129539,OK
178.0,TraderOne,Tick,473,440,33,-33,151200,150300,13461,119639,129539,OK
178.235,TraderOne,Tick,473,440,33,-33,151200,150300,13461,119639,129539,OK
178.5,TraderOne,Tick,473,440,33,-33,151200,150200,13461,119639,129539,OK
178.719,TraderOne,Tick,473,440,33,-33,151200,150200,13461,119639,129539,OK
178.985,TraderOne,Tick,473,450,23,-23,150400,150200,13762,121338,125938,OK
179.266,TraderOne,Tick,473,460,13,-13,150400,150200,14063,123037,125637,OK
179.469,TraderOne,Tick,473,470,3,-3,150400,149900,14364,127736,128636,OK
179.735,TraderOne,Tick,473,470,3,-3,150400,149900,14364,127736,128636,OK
180.047,TraderOne,Tick,473,480,-7,7,150100,149900,14664,129436,128036,OK
180.235,TraderOne,Tick,473,480,-7,7,150000,149800,14664,129436,128036,OK
180.485,TraderOne,Tick,473,480,-7,7,150000,149800,14664,129436,128036,OK
180.75,TraderOne,Tick,473,490,-17,17,150000,149900,14964,130136,128436,OK
180.985,TraderOne,Tick,473,490,-17,17,150000,149900,14964,130136,128436,OK
181.25,TraderOne,Tick,473,500,-27,27,150000,150000,15264,129836,129836,OK
181.563,TraderOne,Tick,473,500,-27,27,149600,149900,15264,129836,137936,OK
181.766,TraderOne,Tick,473,500,-27,27,149600,149900,15264,129836,137936,OK
181.985,TraderOne,Tick,473,510,-37,37,150100,149900,15114,129986,122586,OK
182.266,TraderOne,Tick,473,520,-47,47,150100,149900,15414,129686,120286,OK
182.532,TraderOne,Tick,473,527,-54,54,150100,149900,15624,129476,118676,OK
182.766,TraderOne,Tick,473,527,-54,54,150100,149900,15624,129476,118676,OK
183.016,TraderOne,Tick,473,527,-54,54,150100,149900,15624,129476,118676,OK
183.203,TraderOne,Tick,473,527,-54,54,150100,149900,15624,129476,118676,OK
183.5,TraderOne,Tick,473,527,-54,54,150100,150000,15624,129476,124076,OK
183.766,TraderOne,Tick,483,527,-44,44,149600,150000,15474,131626,144826,OK
184.016,TraderOne,Tick,492,527,-35,35,150000,150000,15339,131761,131761,OK
184.219,TraderOne,Tick,492,527,-35,35,150000,149700,15339,131761,124761,OK
184.516,TraderOne,Tick,492,527,-35,35,150000,149700,15339,131761,124761,OK
184.766,TraderOne,Tick,502,527,-25,25,149700,149700,15638,132462,132462,OK
185.016,TraderOne,Tick,512,527,-15,15,149700,150000,15937,133163,137663,OK
185.25,TraderOne,Tick,512,527,-15,15,149700,150000,15937,133163,137663,OK
185.485,TraderOne,Tick,512,527,-15,15,149700,150000,15937,133163,137663,OK
185.75,TraderOne,Tick,512,527,-15,15,149700,150000,15937,133163,137663,OK
185.953,TraderOne,Tick,512,527,-15,15,149700,150000,15937,133163,137663,OK
186.313,TraderOne,Tick,512,527,-15,15,149600,149800,15937,133163,136163,OK
186.469,TraderOne,Tick,512,527,-15,15,149600,149800,15937,133163,136163,OK
186.75,TraderOne,Tick,522,527,-5,5,149700,149800,16236,132864,133364,OK
187.0,TraderOne,Tick,522,527,-5,5,149700,149800,16236,132864,133364,OK
187.219,TraderOne,Tick,522,527,-5,5,149700,149800,16236,132864,133364,OK
187.516,TraderOne,Tick,522,527,-5,5,149700,150000,16236,132864,134364,OK
187.719,TraderOne,Tick,522,527,-5,5,149700,150000,16236,132864,134364,OK
187.985,TraderOne,Tick,522,527,-5,5,149700,150000,16236,132864,134364,OK
188.297,TraderOne,Tick,522,527,-5,5,149700,150100,16236,132864,134364,OK
188.469,TraderOne,Tick,522,527,-5,5,149700,150100,16236,132864,134364,OK
188.797,TraderOne,Tick,522,527,-5,5,149700,150100,16236,132864,134364,OK
189.0,TraderOne,Tick,522,527,-5,5,149700,150200,16236,132864,134364,OK
189.25,TraderOne,Tick,522,527,-5,5,149700,150200,16236,132864,134364,OK
189.547,TraderOne,Tick,522,527,-5,5,149700,150200,16236,132864,134364,OK
189.75,TraderOne,Tick,532,527,5,-5,150000,150200,16536,135564,134564,OK
190.0,TraderOne,Tick,542,527,15,-15,150000,150200,16836,139264,136264,OK
190.219,TraderOne,Tick,552,527,25,-25,150000,150300,17136,141964,134464,OK
190.485,TraderOne,Tick,552,527,25,-25,150000,150300,17136,141964,134464,OK
190.735,TraderOne,Tick,552,527,25,-25,150000,150300,17136,141964,134464,OK
190.985,TraderOne,Tick,562,527,35,-25,149500,150300,16986,-1356886,135614,OK
191.203,TraderOne,Tick,562,527,35,-35,149500,150400,16986,148114,137614,OK
191.516,TraderOne,Tick,562,527,35,-35,149500,150700,16986,148114,137614,OK
191.75,TraderOne,Tick,572,527,45,-45,150300,150800,17287,150813,137313,OK
191.953,TraderOne,Tick,582,527,55,-55,150300,150800,17588,153512,137012,OK
192.235,TraderOne,Tick,592,527,65,-65,150300,150700,17889,155211,135711,OK
192.563,TraderOne,Tick,592,527,65,-65,150200,150700,17889,155211,135711,OK
192.75,TraderOne,Tick,602,527,75,-75,150800,150700,18190,157910,165410,OK
193.016,TraderOne,Tick,612,527,85,-75,150200,150500,18039,-1348939,130561,OK
193.25,TraderOne,Tick,612,527,85,-85,150200,150500,18039,156061,130561,OK
193.5,TraderOne,Tick,612,527,85,-85,150200,150500,18039,156061,130561,OK
193.782,TraderOne,Tick,612,527,85,-85,150200,150500,18039,156061,130561,OK
193.985,TraderOne,Tick,612,527,85,-85,150200,150500,18039,156061,130561,OK
194.25,TraderOne,Tick,612,527,85,-85,150200,150500,18039,156061,130561,OK
194.5,TraderOne,Tick,612,527,85,-85,150200,150500,18039,156061,130561,OK
194.797,TraderOne,Tick,612,527,85,-85,150200,150500,18039,156061,130561,OK
194.985,TraderOne,Tick,612,527,85,-85,150200,150600,18039,156061,130561,OK
195.266,TraderOne,Tick,612,527,85,-85,150200,150600,18039,156061,130561,OK
195.547,TraderOne,Tick,612,527,85,-85,150200,150600,18039,156061,130561,OK
195.75,TraderOne,Tick,612,527,85,-85,150200,150600,18039,156061,130561,OK
195.953,TraderOne,Tick,612,527,85,-85,150200,150600,18039,156061,130561,OK
196.25,TraderOne,Tick,612,527,85,-85,150200,150600,18039,156061,130561,OK
196.547,TraderOne,Tick,622,527,95,-95,149800,150600,17889,156211,127711,OK
196.782,TraderOne,Tick,622,527,95,-95,149800,150100,17889,156211,127711,OK
197.047,TraderOne,Tick,622,527,95,-95,149800,150000,17889,156211,137211,OK
197.282,TraderOne,Tick,622,527,95,-95,149800,150000,17889,156211,137211,OK
197.469,TraderOne,Tick,622,527,95,-95,149800,150000,17889,156211,137211,OK
197.75,TraderOne,Tick,622,527,95,-95,149800,149800,17889,156211,156211,OK
198.047,TraderOne,Tick,622,527,95,-95,149800,149700,17889,156211,165711,OK
198.203,TraderOne,Tick,622,527,95,-95,149800,149700,17889,156211,165711,OK
198.516,TraderOne,Tick,622,527,95,-95,149800,149500,17889,156211,175211,OK
198.782,TraderOne,Tick,622,527,95,-95,149800,149500,17889,156211,175211,OK
199.063,TraderOne,Tick,622,527,95,-95,149800,149500,17889,156211,175211,OK
199.297,TraderOne,Tick,622,527,95,-95,149800,149500,17889,156211,175211,OK
199.5,TraderOne,Tick,622,527,95,-95,149800,149500,17889,156211,175211,OK
199.703,TraderOne,Tick,622,527,95,-95,149800,149500,17889,156211,175211,OK
200.047,TraderOne,Tick,622,527,95,-95,149800,149500,17889,156211,175211,OK
200.219,TraderOne,Tick,622,527,95,-95,149800,149600,17889,156211,175211,OK
200.5,TraderOne,Tick,622,531,91,-91,149800,149600,17829,156671,174871,OK
200.797,TraderOne,Tick,622,531,91,-91,149800,149600,17829,156671,174871,OK
201.047,TraderOne,Tick,622,531,91,-91,149800,149600,17829,156671,174871,OK
201.297,TraderOne,Tick,622,532,90,-90,150000,149600,17814,156886,174886,OK
201.516,TraderOne,Tick,622,532,90,-90,150000,149800,17814,156886,174886,OK
201.703,TraderOne,Tick,622,532,90,-90,150000,150000,17814,156886,156886,OK
201.953,TraderOne,Tick,632,532,100,-100,149300,150000,17664,159036,129036,OK
202.235,TraderOne,Tick,632,532,100,-100,149300,150200,17664,159036,129036,OK
202.532,TraderOne,Tick,632,532,100,-100,149300,150200,17664,159036,129036,OK
202.703,TraderOne,Tick,632,532,100,-100,149300,150600,17664,159036,129036,OK
202.985,TraderOne,Tick,632,532,100,-100,149300,150600,17664,159036,129036,OK
203.203,TraderOne,Tick,632,532,100,-100,149300,150600,17664,159036,129036,OK
203.469,TraderOne,Tick,632,532,100,-100,149300,150600,17664,159036,129036,OK
203.766,TraderOne,Tick,632,532,100,-100,149300,150600,17664,159036,129036,OK
204.0,TraderOne,Tick,632,532,100,-100,149300,150600,17664,159036,129036,OK
204.266,TraderOne,Tick,632,532,100,-100,149300,150600,17664,159036,129036,OK
204.5,TraderOne,Tick,632,532,100,-100,149300,150600,17664,159036,129036,OK
204.782,TraderOne,Tick,632,532,100,-100,149300,150600,17664,159036,129036,OK
205.032,TraderOne,Tick,632,532,100,-100,149700,150100,17664,159036,129036,OK
205.25,TraderOne,Tick,632,532,100,-100,149700,149700,17664,159036,159036,OK
205.516,TraderOne,Tick,632,542,90,-90,150400,149700,17514,159186,177186,OK
205.766,TraderOne,Tick,632,542,90,-90,150400,149700,17514,159186,177186,OK
205.985,TraderOne,Tick,632,542,90,-90,150400,149800,17514,159186,186186,OK
206.266,TraderOne,Tick,632,552,80,-80,150300,149800,17364,160336,184336,OK
206.547,TraderOne,Tick,632,552,80,-80,150300,149800,17364,160336,184336,OK
206.766,TraderOne,Tick,632,552,80,-80,150300,149800,17364,160336,184336,OK
206.985,TraderOne,Tick,632,552,80,-80,150300,149800,17364,160336,184336,OK
207.297,TraderOne,Tick,632,552,80,-80,150300,149800,17364,160336,184336,OK
207.5,TraderOne,Tick,632,552,80,-80,150300,149800,17364,160336,184336,OK
207.766,TraderOne,Tick,632,552,80,-80,150300,149800,17364,160336,184336,OK
207.985,TraderOne,Tick,632,552,80,-80,150300,149800,17364,160336,184336,OK
208.266,TraderOne,Tick,642,552,90,-90,149200,149800,17214,161486,134486,OK
208.5,TraderOne,Tick,642,552,90,-90,149200,149800,17214,161486,134486,OK
208.797,TraderOne,Tick,642,552,90,-90,149800,149800,17214,161486,161486,OK
209.016,TraderOne,Tick,642,552,90,-90,149800,149800,17214,161486,161486,OK
209.25,TraderOne,Tick,642,552,90,-90,149800,149800,17214,161486,161486,OK
209.469,TraderOne,Tick,642,552,90,-90,149800,149800,17214,161486,161486,OK
209.735,TraderOne,Tick,642,552,90,-90,150300,149800,17214,161486,188486,OK
210.0,TraderOne,Tick,642,552,90,-90,150300,149800,17214,161486,188486,OK
210.25,TraderOne,Tick,642,552,90,-90,150300,149800,17214,161486,188486,OK
210.547,TraderOne,Tick,642,552,90,-90,150300,149800,17214,161486,188486,OK
210.75,TraderOne,Tick,642,552,90,-90,150300,149800,17214,161486,188486,OK
210.969,TraderOne,Tick,642,562,80,-80,150400,149900,17064,161636,185636,OK
211.266,TraderOne,Tick,642,571,71,-71,150200,149900,17334,164066,185366,OK
211.547,TraderOne,Tick,642,571,71,-71,150200,149900,17334,164066,185366,OK
211.782,TraderOne,Tick,642,571,71,-71,150200,149600,17334,164066,178266,OK
212.032,TraderOne,Tick,652,571,81,-81,149100,149600,17185,166215,150015,OK
212.25,TraderOne,Tick,652,571,81,-81,149100,149700,17185,166215,150015,OK
212.5,TraderOne,Tick,652,571,81,-81,149100,149700,17185,166215,150015,OK
212.735,TraderOne,Tick,652,581,71,-71,150200,149700,17035,168365,182565,OK
212.985,TraderOne,Tick,652,581,71,-71,150200,149700,17035,168365,182565,OK
213.219,TraderOne,Tick,652,581,71,-71,150200,149300,17035,168365,182565,OK
213.453,TraderOne,Tick,652,581,71,-71,150200,149300,17035,168365,182565,OK
213.75,TraderOne,Tick,652,581,71,-71,150200,149300,17035,168365,182565,OK
214.047,TraderOne,Tick,652,581,71,-71,150200,149300,17035,168365,182565,OK
214.297,TraderOne,Tick,652,581,71,-71,150200,149300,17035,168365,182565,OK
214.5,TraderOne,Tick,652,581,71,-71,150200,149300,17035,168365,182565,OK
214.735,TraderOne,Tick,652,581,71,-71,150200,149600,17035,168365,182565,OK
214.969,TraderOne,Tick,652,581,71,-71,150200,149600,17035,168365,182565,OK
215.25,TraderOne,Tick,652,581,71,-71,150200,149600,17035,168365,182565,OK
215.469,TraderOne,Tick,652,581,71,-71,150200,149600,17035,168365,182565,OK
215.735,TraderOne,Tick,652,581,71,-71,150200,149600,17035,168365,182565,OK
216.032,TraderOne,Tick,658,581,77,-77,149300,149600,16945,168455,153055,OK
216.297,TraderOne,Tick,658,581,77,-77,149300,149400,16945,168455,160755,OK
216.516,TraderOne,Tick,658,581,77,-77,149300,149500,16945,168455,153055,OK
216.719,TraderOne,Tick,658,581,77,-77,149300,149700,16945,168455,153055,OK
217.032,TraderOne,Tick,658,581,77,-77,149100,150000,16945,168455,145355,OK
217.203,TraderOne,Tick,668,581,87,-87,149500,150000,17244,172156,146056,OK
217.516,TraderOne,Tick,678,581,97,-97,149500,150100,17543,175857,146757,OK
217.735,TraderOne,Tick,678,581,97,-97,149500,150100,17543,175857,146757,OK
218.0,TraderOne,Tick,678,581,97,-97,149500,149900,17543,175857,146757,OK
218.266,TraderOne,Tick,678,581,97,-97,149500,149900,17543,175857,146757,OK
218.516,TraderOne,Tick,678,581,97,-97,149500,149900,17543,175857,146757,OK
218.797,TraderOne,Tick,678,581,97,-97,149500,149900,17543,175857,146757,OK
219.063,TraderOne,Tick,678,581,97,-97,150500,149900,17543,175857,204957,OK
219.25,TraderOne,Tick,678,581,97,-97,150500,149900,17543,175857,204957,OK
219.453,TraderOne,Tick,678,591,87,-87,150400,149900,17393,176007,202107,OK
219.75,TraderOne,Tick,678,591,87,-87,150400,149900,17393,176007,202107,OK
220.0,TraderOne,Tick,678,601,77,-77,150500,149900,17243,176157,199257,OK
220.203,TraderOne,Tick,678,601,77,-77,150500,149900,17243,176157,199257,OK
220.5,TraderOne,Tick,678,601,77,-77,150500,149900,17243,176157,199257,OK
220.797,TraderOne,Tick,678,601,77,-77,150500,150000,17243,176157,199257,OK
221.047,TraderOne,Tick,678,601,77,-77,150500,150000,17243,176157,199257,OK
221.235,TraderOne,Tick,678,601,77,-77,150500,150000,17243,176157,199257,OK
221.516,TraderOne,Tick,678,601,77,-77,150500,150100,17243,176157,199257,OK
221.719,TraderOne,Tick,678,601,77,-77,150500,150100,17243,176157,199257,OK
222.0,TraderOne,Tick,678,601,77,-77,150500,150100,17243,176157,199257,OK
222.25,TraderOne,Tick,678,601,77,-77,150500,150100,17243,176157,199257,OK
222.485,TraderOne,Tick,678,601,77,-77,150500,150100,17243,176157,199257,OK
222.766,TraderOne,Tick,688,601,87,-87,149500,150000,17093,176307,150207,OK
222.969,TraderOne,Tick,688,601,87,-87,149500,150000,17093,176307,150207,OK
223.266,TraderOne,Tick,688,611,77,-77,150100,150000,17393,176007,183707,OK
223.547,TraderOne,Tick,688,611,77,-77,150100,150000,17393,176007,183707,OK
223.766,TraderOne,Tick,688,621,67,-67,150100,150000,17693,175707,182407,OK
223.985,TraderOne,Tick,688,631,57,-57,150400,150000,17994,177406,194506,OK
224.266,TraderOne,Tick,688,641,47,-47,150400,150000,18295,181105,195205,OK
224.5,TraderOne,Tick,688,651,37,-37,150100,150000,18595,183605,187305,OK
224.719,TraderOne,Tick,688,661,27,-27,150100,149800,18895,184305,192405,OK
224.969,TraderOne,Tick,688,671,17,-17,150100,149400,19195,187005,190405,OK
225.219,TraderOne,Tick,688,671,17,-17,150100,149500,19195,187005,190405,OK
225.5,TraderOne,Tick,688,671,17,-17,150100,149500,19195,187005,190405,OK
225.719,TraderOne,Tick,688,671,17,-17,150100,149500,19195,187005,190405,OK
225.953,TraderOne,Tick,688,671,17,-17,150100,149500,19195,187005,190405,OK
226.235,TraderOne,Tick,698,671,27,-27,149300,149500,19045,187155,181755,OK
226.469,TraderOne,Tick,698,671,27,-27,149300,149500,19045,187155,181755,OK
226.766,TraderOne,Tick,698,681,17,-17,150300,149500,18895,187305,190705,OK
227.032,TraderOne,Tick,698,681,17,-17,150300,149500,18895,187305,190705,OK
227.266,TraderOne,Tick,698,681,17,-17,150300,149500,18895,187305,190705,OK
227.485,TraderOne,Tick,698,681,17,-17,150300,150200,18895,187305,189005,OK
227.703,TraderOne,Tick,698,681,17,-17,150300,150200,18895,187305,189005,OK
228.032,TraderOne,Tick,698,681,17,-17,150300,150600,18895,187305,182205,OK
228.266,TraderOne,Tick,698,681,17,-17,150300,150600,18895,187305,182205,OK
228.516,TraderOne,Tick,708,681,27,-27,150600,150600,19196,188504,188504,OK
228.703,TraderOne,Tick,708,681,27,-27,150600,150600,19196,188504,188504,OK
229.016,TraderOne,Tick,718,681,37,-37,150100,150600,19497,188203,177103,OK
229.25,TraderOne,Tick,728,681,47,-47,150600,150600,19798,188902,188902,OK
229.5,TraderOne,Tick,738,681,57,-57,150600,150600,20099,189601,189601,OK
229.703,TraderOne,Tick,748,681,67,-67,150600,150600,20400,190300,190300,OK
229.953,TraderOne,Tick,758,681,77,-77,150600,150600,20701,190999,190999,OK
230.297,TraderOne,Tick,768,681,87,-87,150600,150700,21002,191698,182998,OK
230.469,TraderOne,Tick,778,681,97,-97,150600,150700,21303,192397,182697,OK
230.75,TraderOne,Tick,778,681,97,-97,150600,150700,21303,192397,182697,OK
231.032,TraderOne,Tick,778,681,97,-97,150600,150700,21303,192397,182697,OK
231.219,TraderOne,Tick,778,681,97,-97,150600,150700,21303,192397,182697,OK
231.485,TraderOne,Tick,778,681,97,-97,150600,150700,21303,192397,182697,OK
231.75,TraderOne,Tick,778,681,97,-97,150600,150700,21303,192397,182697,OK
232.047,TraderOne,Tick,778,681,97,-97,150700,150700,21303,192397,192397,OK
232.235,TraderOne,Tick,778,681,97,-97,150700,150700,21303,192397,192397,OK
232.516,TraderOne,Tick,778,681,97,-97,150700,150700,21303,192397,192397,OK
232.782,TraderOne,Tick,778,681,97,-97,150700,150700,21303,192397,192397,OK
233.016,TraderOne,Tick,778,681,97,-97,150700,150700,21303,192397,192397,OK
233.203,TraderOne,Tick,778,681,97,-97,150700,151100,21303,192397,163297,OK
233.5,TraderOne,Tick,778,681,97,-97,150700,151100,21303,192397,163297,OK
233.703,TraderOne,Tick,778,681,97,-97,150700,151100,21303,192397,163297,OK
234.032,TraderOne,Tick,778,681,97,-97,150700,151100,21303,192397,163297,OK
234.266,TraderOne,Tick,778,681,97,-97,150700,151100,21303,192397,163297,OK
234.453,TraderOne,Tick,778,681,97,-97,150700,151200,21303,192397,163297,OK
234.766,TraderOne,Tick,778,681,97,-97,150700,151200,21303,192397,163297,OK
235.0,TraderOne,Tick,778,681,97,-97,150800,151200,21303,192397,163297,OK
235.219,TraderOne,Tick,778,681,97,-97,150900,151500,21303,192397,163297,OK
235.547,TraderOne,Tick,778,681,97,-97,150900,151500,21303,192397,163297,OK
235.766,TraderOne,Tick,778,681,97,-97,151100,151600,21303,192397,163297,OK
236.047,TraderOne,Tick,778,681,97,-97,151100,151600,21303,192397,163297,OK
236.25,TraderOne,Tick,778,681,97,-97,151100,151600,21303,192397,163297,OK
236.453,TraderOne,Tick,778,681,97,-97,151000,151600,21303,192397,163297,OK
236.735,TraderOne,Tick,778,681,97,-97,151200,151600,21303,192397,163297,OK
236.985,TraderOne,Tick,778,681,97,-97,151000,151600,21303,192397,163297,OK
237.297,TraderOne,Tick,778,681,97,-97,151000,151700,21303,192397,163297,OK
237.547,TraderOne,Tick,778,681,97,-97,151000,151700,21303,192397,163297,OK
237.75,TraderOne,Tick,778,681,97,-97,151000,151700,21303,192397,163297,OK
237.969,TraderOne,Tick,778,681,97,-97,151000,151700,21303,192397,163297,OK
238.25,TraderOne,Tick,778,681,97,-97,151000,151700,21303,192397,163297,OK
238.453,TraderOne,Tick,778,681,97,-97,151000,151700,21303,192397,163297,OK
238.719,TraderOne,Tick,778,681,97,-97,151000,151700,21303,192397,163297,OK
238.985,TraderOne,Tick,778,681,97,-97,151000,151700,21303,192397,163297,OK
239.235,TraderOne,Tick,778,681,97,-97,151000,151500,21303,192397,163297,OK
239.453,TraderOne,Tick,778,681,97,-97,151000,151500,21303,192397,163297,OK
239.719,TraderOne,Tick,778,681,97,-97,151300,151600,21303,192397,163297,OK
240.032,TraderOne,Tick,778,681,97,-97,151300,151500,21303,192397,172997,OK
240.219,TraderOne,Tick,778,681,97,-97,151300,151400,21303,192397,182697,OK
240.516,TraderOne,Tick,778,681,97,-97,151400,151400,21303,192397,192397,OK
240.813,TraderOne,Tick,778,681,97,-97,151400,151500,21303,192397,182697,OK
240.985,TraderOne,Tick,778,681,97,-97,151400,151500,21303,192397,182697,OK
241.203,TraderOne,Tick,778,681,97,-97,151400,151500,21303,192397,182697,OK
241.453,TraderOne,Tick,778,681,97,-97,151400,151500,21303,192397,182697,OK
241.75,TraderOne,Tick,778,681,97,-97,151400,151500,21303,192397,182697,OK
242.0,TraderOne,Tick,778,681,97,-97,150900,151500,21303,192397,163297,OK
242.297,TraderOne,Tick,778,681,97,-97,150800,151300,21303,192397,163297,OK
242.453,TraderOne,Tick,778,681,97,-97,150800,151300,21303,192397,163297,OK
242.735,TraderOne,Tick,778,681,97,-97,150800,151300,21303,192397,163297,OK
242.969,TraderOne,Tick,778,681,97,-97,150800,151300,21303,192397,163297,OK
243.203,TraderOne,Tick,778,681,97,-97,150800,151300,21303,192397,163297,OK
243.5,TraderOne,Tick,778,681,97,-97,150800,151300,21303,192397,163297,OK
243.782,TraderOne,Tick,778,681,97,-97,150800,151300,21303,192397,163297,OK
244.016,TraderOne,Tick,778,681,97,-97,150800,151500,21303,192397,163297,OK
244.282,TraderOne,Tick,778,681,97,-97,150800,151500,21303,192397,163297,OK
244.532,TraderOne,Tick,778,681,97,-97,150800,151500,21303,192397,163297,OK
244.782,TraderOne,Tick,778,681,97,-97,150800,151500,21303,192397,163297,OK
245.016,TraderOne,Tick,778,681,97,-97,150800,151500,21303,192397,163297,OK
245.203,TraderOne,Tick,778,681,97,-97,150800,151400,21303,192397,163297,OK
245.453,TraderOne,Tick,778,681,97,-97,150800,151600,21303,192397,163297,OK
245.719,TraderOne,Tick,778,681,97,-97,151400,151800,21303,192397,163297,OK
246.047,TraderOne,Tick,778,681,97,-97,151400,151800,21303,192397,163297,OK
246.25,TraderOne,Tick,778,681,97,-97,151400,151800,21303,192397,163297,OK
246.469,TraderOne,Tick,778,681,97,-97,151400,151800,21303,192397,163297,OK
246.703,TraderOne,Tick,778,681,97,-97,151400,151800,21303,192397,163297,OK
246.985,TraderOne,Tick,778,681,97,-97,151400,152100,21303,192397,163297,OK
247.219,TraderOne,Tick,778,681,97,-97,151700,152100,21303,192397,163297,OK
247.516,TraderOne,Tick,778,681,97,-97,151700,152100,21303,192397,163297,OK
247.766,TraderOne,Tick,778,681,97,-97,151400,152100,21303,192397,163297,OK
247.985,TraderOne,Tick,778,681,97,-97,151400,152100,21303,192397,163297,OK
248.25,TraderOne,Tick,778,681,97,-97,151500,152100,21303,192397,163297,OK
248.516,TraderOne,Tick,778,681,97,-97,151500,152100,21303,192397,163297,OK
248.719,TraderOne,Tick,778,681,97,-97,151500,152100,21303,192397,163297,OK
249.063,TraderOne,Tick,778,681,97,-97,151800,152300,21303,192397,163297,OK
249.266,TraderOne,Tick,778,681,97,-97,152000,152700,21303,192397,163297,OK
249.5,TraderOne,Tick,778,681,97,-97,152000,152900,21303,192397,163297,OK
249.75,TraderOne,Tick,778,681,97,-97,152400,152700,21303,192397,163297,OK
249.969,TraderOne,Tick,778,681,97,-97,152400,152700,21303,192397,163297,OK
250.297,TraderOne,Tick,778,681,97,-97,152400,152700,21303,192397,163297,OK
250.563,TraderOne,Tick,778,681,97,-97,152600,152700,21303,192397,182697,OK
250.797,TraderOne,Tick,778,681,97,-97,152600,152700,21303,192397,182697,OK
251.016,TraderOne,Tick,778,681,97,-97,152600,152700,21303,192397,182697,OK
251.313,TraderOne,Tick,778,681,97,-97,152000,152500,21303,192397,163297,OK
251.516,TraderOne,Tick,778,681,97,-97,152000,152600,21303,192397,163297,OK
251.766,TraderOne,Tick,778,681,97,-97,152000,152500,21303,192397,163297,OK
251.969,TraderOne,Tick,778,681,97,-97,152000,152500,21303,192397,163297,OK
252.25,TraderOne,Tick,778,681,97,-97,152000,152500,21303,192397,163297,OK
252.453,TraderOne,Tick,778,681,97,-97,152000,152500,21303,192397,163297,OK
252.813,TraderOne,Tick,778,681,97,-97,152600,152500,21303,192397,202097,OK
253.016,TraderOne,Tick,778,681,97,-97,152600,152500,21303,192397,202097,OK
253.203,TraderOne,Tick,778,681,97,-97,152600,152500,21303,192397,202097,OK
253.469,TraderOne,Tick,778,681,97,-97,152600,152500,21303,192397,202097,OK
253.782,TraderOne,Tick,778,681,97,-97,152600,152500,21303,192397,202097,OK
254.0,TraderOne,Tick,778,681,97,-97,152600,152500,21303,192397,202097,OK
254.282,TraderOne,Tick,778,681,97,-97,152600,152500,21303,192397,202097,OK
254.547,TraderOne,Tick,778,681,97,-97,152200,152500,21303,192397,163297,OK
254.703,TraderOne,Tick,778,681,97,-97,152200,152500,21303,192397,163297,OK
255.047,TraderOne,Tick,778,681,97,-97,152200,152500,21303,192397,163297,OK
255.219,TraderOne,Tick,778,681,97,-97,152200,152500,21303,192397,163297,OK
255.547,TraderOne,Tick,778,681,97,-97,152200,152500,21303,192397,163297,OK
255.766,TraderOne,Tick,778,681,97,-97,152200,152500,21303,192397,163297,OK
256.0,TraderOne,Tick,778,681,97,-97,152200,152200,21303,192397,192397,OK
256.235,TraderOne,Tick,778,681,97,-97,152200,152000,21303,192397,211797,OK
256.516,TraderOne,Tick,778,681,97,-97,152200,152000,21303,192397,211797,OK
256.703,TraderOne,Tick,778,681,97,-97,152200,152000,21303,192397,211797,OK
257.0,TraderOne,Tick,778,681,97,-97,152200,152000,21303,192397,211797,OK
257.25,TraderOne,Tick,778,681,97,-97,151400,152000,21303,192397,163297,OK
257.5,TraderOne,Tick,778,681,97,-97,151400,152000,21303,192397,163297,OK
257.797,TraderOne,Tick,778,681,97,-97,151400,152000,21303,192397,163297,OK
258.047,TraderOne,Tick,778,681,97,-97,151400,152000,21303,192397,163297,OK
258.297,TraderOne,Tick,778,681,97,-97,151700,151900,21303,192397,172997,OK
258.5,TraderOne,Tick,778,681,97,-97,151700,151900,21303,192397,172997,OK
258.719,TraderOne,Tick,778,681,97,-97,151700,151700,21303,192397,192397,OK
258.969,TraderOne,Tick,778,681,97,-97,151700,151700,21303,192397,192397,OK
259.203,TraderOne,Tick,778,681,97,-97,151700,151600,21303,192397,202097,OK
259.5,TraderOne,Tick,778,681,97,-97,151700,151600,21303,192397,202097,OK
259.703,TraderOne,Tick,778,681,97,-97,151700,151600,21303,192397,202097,OK
259.985,TraderOne,Tick,778,681,97,-97,151700,151600,21303,192397,202097,OK
260.235,TraderOne,Tick,778,681,97,-97,151300,151600,21303,192397,163297,OK
260.5,TraderOne,Tick,778,681,97,-97,151300,151600,21303,192397,163297,OK
260.797,TraderOne,Tick,778,681,97,-97,151300,151800,21303,192397,163297,OK
261.047,TraderOne,Tick,778,681,97,-97,151300,151800,21303,192397,163297,OK
261.297,TraderOne,Tick,778,681,97,-97,151300,151800,21303,192397,163297,OK
261.485,TraderOne,Tick,778,681,97,-97,151300,151800,21303,192397,163297,OK
261.766,TraderOne,Tick,778,691,87,-87,152000,151800,21151,192549,209949,OK
262.016,TraderOne,Tick,788,691,97,-97,151700,151800,20999,191701,182001,OK
262.297,TraderOne,Tick,788,691,97,-97,151700,151800,20999,191701,182001,OK
262.532,TraderOne,Tick,788,691,97,-97,151700,151800,20999,191701,182001,OK
262.797,TraderOne,Tick,788,691,97,-97,151700,151800,20999,191701,182001,OK
263.016,TraderOne,Tick,788,691,97,-97,151700,151800,20999,191701,182001,OK
263.219,TraderOne,Tick,788,691,97,-97,151700,152200,20999,191701,162601,OK
263.453,TraderOne,Tick,788,691,97,-97,151700,152200,20999,191701,162601,OK
263.766,TraderOne,Tick,788,691,97,-97,151700,152200,20999,191701,162601,OK
264.016,TraderOne,Tick,788,691,97,-97,151700,152200,20999,191701,162601,OK
264.219,TraderOne,Tick,788,691,97,-97,151700,152200,20999,191701,162601,OK
264.469,TraderOne,Tick,788,691,97,-97,151700,152200,20999,191701,162601,OK
264.797,TraderOne,Tick,788,691,97,-97,151700,151800,20999,191701,182001,OK
265.016,TraderOne,Tick,788,691,97,-97,151700,151800,20999,191701,182001,OK
265.235,TraderOne,Tick,788,691,97,-97,151700,151800,20999,191701,182001,OK
265.516,TraderOne,Tick,788,691,97,-97,151700,151800,20999,191701,182001,OK
265.735,TraderOne,Tick,788,691,97,-97,151700,151800,20999,191701,182001,OK
266.032,TraderOne,Tick,788,691,97,-97,152100,151800,20999,191701,220801,OK
266.313,TraderOne,Tick,788,691,97,-97,152100,151800,20999,191701,220801,OK
266.532,TraderOne,Tick,788,691,97,-97,152100,151800,20999,191701,220801,OK
266.782,TraderOne,Tick,788,691,97,-97,152100,151800,20999,191701,220801,OK
267.0,TraderOne,Tick,788,691,97,-97,152100,152200,20999,191701,182001,OK
267.219,TraderOne,Tick,788,691,97,-97,152100,152200,20999,191701,182001,OK
267.469,TraderOne,Tick,788,691,97,-97,152100,152200,20999,191701,182001,OK
267.782,TraderOne,Tick,788,691,97,-97,152300,152200,20999,191701,201401,OK
267.969,TraderOne,Tick,788,691,97,-97,152300,152200,20999,191701,201401,OK
268.266,TraderOne,Tick,788,691,97,-97,152300,152200,20999,191701,201401,OK
268.485,TraderOne,Tick,788,691,97,-97,152300,152200,20999,191701,201401,OK
268.75,TraderOne,Tick,788,691,97,-97,152300,152600,20999,191701,162601,OK
268.969,TraderOne,Tick,788,691,97,-97,152300,152600,20999,191701,162601,OK
269.297,TraderOne,Tick,788,691,97,-97,152300,152600,20999,191701,162601,OK
269.485,TraderOne,Tick,788,691,97,-97,152300,153000,20999,191701,162601,OK
269.766,TraderOne,Tick,788,691,97,-97,152300,153000,20999,191701,162601,OK
270.0,TraderOne,Tick,788,691,97,-97,152100,153000,20999,191701,162601,OK
270.297,TraderOne,Tick,788,691,97,-97,152100,153000,20999,191701,162601,OK
270.469,TraderOne,Tick,788,691,97,-97,152100,152900,20999,191701,162601,OK
270.719,TraderOne,Tick,788,691,97,-97,152100,152900,20999,191701,162601,OK
271.032,TraderOne,Tick,788,691,97,-97,152300,153000,20999,191701,162601,OK
271.282,TraderOne,Tick,788,691,97,-97,152300,153300,20999,191701,162601,OK
271.532,TraderOne,Tick,788,691,97,-97,152700,153300,20999,191701,162601,OK
271.782,TraderOne,Tick,788,691,97,-97,153000,153600,20999,191701,162601,OK
272.016,TraderOne,Tick,788,691,97,-97,153100,153600,20999,191701,162601,OK
272.25,TraderOne,Tick,788,691,97,-97,153100,153600,20999,191701,162601,OK
272.469,TraderOne,Tick,788,691,97,-97,153600,153600,20999,191701,191701,OK
272.75,TraderOne,Tick,788,691,97,-97,152800,153600,20999,191701,162601,OK
272.985,TraderOne,Tick,788,691,97,-97,152800,153600,20999,191701,162601,OK
273.266,TraderOne,Tick,788,691,97,-97,152800,153600,20999,191701,162601,OK
273.453,TraderOne,Tick,788,691,97,-97,152800,153600,20999,191701,162601,OK
273.735,TraderOne,Tick,788,691,97,-97,152600,153600,20999,191701,162601,OK
273.985,TraderOne,Tick,788,691,97,-97,152600,153600,20999,191701,162601,OK
274.282,TraderOne,Tick,788,691,97,-97,153800,153600,20999,191701,211101,OK
274.485,TraderOne,Tick,788,691,97,-97,153800,152900,20999,191701,220801,OK
274.766,TraderOne,Tick,788,691,97,-97,153800,152900,20999,191701,220801,OK
274.953,TraderOne,Tick,788,691,97,-97,153800,152900,20999,191701,220801,OK
275.25,TraderOne,Tick,788,691,97,-97,152300,152700,20999,191701,162601,OK
275.5,TraderOne,Tick,788,691,97,-97,153400,152700,20999,191701,220801,OK
275.766,TraderOne,Tick,788,691,97,-97,153400,152700,20999,191701,220801,OK
275.969,TraderOne,Tick,788,691,97,-97,153400,152700,20999,191701,220801,OK
276.219,TraderOne,Tick,788,691,97,-97,153400,153000,20999,191701,220801,OK
276.5,TraderOne,Tick,788,691,97,-97,153400,153100,20999,191701,220801,OK
276.719,TraderOne,Tick,788,691,97,-97,153400,153100,20999,191701,220801,OK
276.985,TraderOne,Tick,788,691,97,-97,152400,153100,20999,191701,162601,OK
277.282,TraderOne,Tick,788,691,97,-97,152400,153100,20999,191701,162601,OK
277.547,TraderOne,Tick,788,691,97,-97,152400,152900,20999,191701,162601,OK
277.797,TraderOne,Tick,788,691,97,-97,152400,152900,20999,191701,162601,OK
278.032,TraderOne,Tick,788,691,97,-97,152400,152900,20999,191701,162601,OK
278.297,TraderOne,Tick,788,691,97,-97,152400,152900,20999,191701,162601,OK
278.532,TraderOne,Tick,788,691,97,-97,152400,153000,20999,191701,162601,OK
278.797,TraderOne,Tick,788,691,97,-97,152400,153200,20999,191701,162601,OK
279.032,TraderOne,Tick,788,691,97,-97,152400,153200,20999,191701,162601,OK
279.203,TraderOne,Tick,788,691,97,-97,152400,153200,20999,191701,162601,OK
279.516,TraderOne,Tick,788,691,97,-97,152400,153200,20999,191701,162601,OK
279.782,TraderOne,Tick,788,691,97,-97,152400,153200,20999,191701,162601,OK
280.016,TraderOne,Tick,788,691,97,-97,152400,153200,20999,191701,162601,OK
280.219,TraderOne,Tick,788,691,97,-97,152400,153000,20999,191701,162601,OK
280.5,TraderOne,Tick,788,691,97,-97,152400,152800,20999,191701,162601,OK
280.75,TraderOne,Tick,788,691,97,-97,152400,152800,20999,191701,162601,OK
281.016,TraderOne,Tick,788,691,97,-97,152400,152600,20999,191701,172301,OK
281.203,TraderOne,Tick,788,691,97,-97,152400,152600,20999,191701,172301,OK
281.5,TraderOne,Tick,788,691,97,-97,152400,152700,20999,191701,162601,OK
281.797,TraderOne,Tick,788,691,97,-97,152400,152700,20999,191701,162601,OK
282.047,TraderOne,Tick,788,691,97,-97,152400,152700,20999,191701,162601,OK
282.219,TraderOne,Tick,788,691,97,-97,152800,152700,20999,191701,201401,OK
282.547,TraderOne,Tick,788,691,97,-97,152800,152700,20999,191701,201401,OK
282.782,TraderOne,Tick,788,691,97,-97,152800,152800,20999,191701,191701,OK
283.032,TraderOne,Tick,788,691,97,-97,152800,152800,20999,191701,191701,OK
283.25,TraderOne,Tick,788,691,97,-97,152800,152800,20999,191701,191701,OK
283.469,TraderOne,Tick,788,691,97,-97,152800,152800,20999,191701,191701,OK
283.797,TraderOne,Tick,788,691,97,-97,152300,152800,20999,191701,162601,OK
283.969,TraderOne,Tick,788,691,97,-97,152300,152800,20999,191701,162601,OK
284.219,TraderOne,Tick,788,691,97,-97,153600,152800,20999,191701,220801,OK
284.469,TraderOne,Tick,788,691,97,-97,153600,152800,20999,191701,220801,OK
284.797,TraderOne,Tick,788,691,97,-97,152400,152800,20999,191701,162601,OK
285.016,TraderOne,Tick,788,691,97,-97,152400,153100,20999,191701,162601,OK
285.282,TraderOne,Tick,788,691,97,-97,152600,153500,20999,191701,162601,OK
285.485,TraderOne,Tick,788,701,87,-87,153900,153500,20845,190855,216955,OK
285.735,TraderOne,Tick,788,701,87,-87,153900,153500,20845,190855,216955,OK
285.953,TraderOne,Tick,788,701,87,-87,153900,153900,20845,190855,190855,OK
286.313,TraderOne,Tick,788,701,87,-87,153900,153600,20845,190855,216955,OK
286.547,TraderOne,Tick,788,701,87,-87,153900,153600,20845,190855,216955,OK
286.735,TraderOne,Tick,788,701,87,-87,153900,153600,20845,190855,216955,OK
287.016,TraderOne,Tick,788,711,77,-77,153900,153500,20691,191009,214109,OK
287.25,TraderOne,Tick,788,711,77,-77,153900,153500,20691,191009,214109,OK
287.532,TraderOne,Tick,788,711,77,-77,153100,153600,20691,191009,167909,OK
287.766,TraderOne,Tick,788,711,77,-77,153100,153600,20691,191009,167909,OK
288.047,TraderOne,Tick,788,711,77,-77,153100,153600,20691,191009,167909,OK
288.219,TraderOne,Tick,788,711,77,-77,153100,153400,20691,191009,167909,OK
288.5,TraderOne,Tick,788,711,77,-77,153100,153400,20691,191009,167909,OK
288.719,TraderOne,Tick,788,711,77,-77,153100,153400,20691,191009,167909,OK
289.016,TraderOne,Tick,788,711,77,-77,153100,153400,20691,191009,167909,OK
289.235,TraderOne,Tick,788,711,77,-77,153100,153400,20691,191009,167909,OK
289.5,TraderOne,Tick,788,711,77,-77,153100,153400,20691,191009,167909,OK
289.735,TraderOne,Tick,788,711,77,-77,153100,153400,20691,191009,167909,OK
290.047,TraderOne,Tick,788,711,77,-77,153100,153400,20691,191009,167909,OK
290.266,TraderOne,Tick,788,711,77,-77,153100,153500,20691,191009,167909,OK
290.516,TraderOne,Tick,788,711,77,-77,153400,153500,20691,191009,183309,OK
290.75,TraderOne,Tick,788,711,77,-77,153400,153500,20691,191009,183309,OK
291.0,TraderOne,Tick,796,721,75,-75,153400,153500,20414,191286,183786,OK
291.297,TraderOne,Tick,796,721,75,-75,153400,153500,20414,191286,183786,OK
291.547,TraderOne,Tick,796,721,75,-75,153900,153500,20414,191286,213786,OK
291.782,TraderOne,Tick,796,721,75,-75,153900,153500,20414,191286,213786,OK
291.985,TraderOne,Tick,796,721,75,-75,153900,153500,20414,191286,213786,OK
292.25,TraderOne,Tick,796,721,75,-75,153900,153500,20414,191286,213786,OK
292.547,TraderOne,Tick,796,721,75,-75,153900,153500,20414,191286,213786,OK
292.766,TraderOne,Tick,796,721,75,-75,153900,153600,20414,191286,213786,OK
292.985,TraderOne,Tick,796,721,75,-75,153900,153600,20414,191286,213786,OK
293.266,TraderOne,Tick,796,731,65,-65,153900,153600,20722,192978,212478,OK
293.5,TraderOne,Tick,796,731,65,-65,153900,153400,20722,192978,212478,OK
293.719,TraderOne,Tick,796,741,55,-55,153900,153400,21030,195670,212170,OK
294.016,TraderOne,Tick,796,751,45,-45,153900,153400,21338,199362,212862,OK
294.297,TraderOne,Tick,796,761,35,-35,153900,153400,21646,202054,212554,OK
294.485,TraderOne,Tick,796,761,35,-35,153900,153400,21646,202054,212554,OK
294.797,TraderOne,Tick,796,761,35,-35,154000,153400,21646,202054,212554,OK
295.016,TraderOne,Tick,796,771,25,-25,153900,153500,21954,205746,213246,OK
295.266,TraderOne,Tick,796,771,25,-25,153900,153500,21954,205746,213246,OK
295.516,TraderOne,Tick,796,771,25,-25,153800,153500,21954,205746,213246,OK
295.766,TraderOne,Tick,796,771,25,-25,153800,153500,21954,205746,213246,OK
296.047,TraderOne,Tick,796,771,25,-25,153800,153500,21954,205746,213246,OK
296.282,TraderOne,Tick,796,771,25,-25,153800,153500,21954,205746,213246,OK
296.547,TraderOne,Tick,796,781,15,-15,153800,153500,22262,207438,211938,OK
296.766,TraderOne,Tick,796,781,15,-15,153800,153400,22262,207438,211938,OK
297.016,TraderOne,Tick,796,781,15,-15,153800,153400,22262,207438,211938,OK
297.282,TraderOne,Tick,796,781,15,-15,153800,153200,22262,207438,211938,OK
297.5,TraderOne,Tick,796,791,5,-5,153700,153300,22569,211131,212631,OK
297.703,TraderOne,Tick,796,801,-5,5,153700,153300,22876,214824,213324,OK
298.047,TraderOne,Tick,796,801,-5,5,153800,153500,22876,214824,213324,OK
298.313,TraderOne,Tick,796,801,-5,5,153100,153600,22876,214824,216324,OK
298.453,TraderOne,Tick,796,801,-5,5,153100,153600,22876,214824,216324,OK
298.813,TraderOne,Tick,796,801,-5,5,153100,153600,22876,214824,216324,OK
299.032,TraderOne,Tick,796,801,-5,5,153100,153500,22876,214824,216324,OK
299.266,TraderOne,Tick,806,801,5,-5,153100,153400,23182,217518,216018,OK
299.516,TraderOne,Tick,806,801,5,-5,153100,153400,23182,217518,216018,OK
299.766,TraderOne,Tick,806,801,5,-5,153100,153500,23182,217518,216018,OK
299.969,TraderOne,Tick,816,801,15,-15,153100,153700,23488,221212,216712,OK
300.297,TraderOne,Tick,816,801,15,-15,153100,153700,23488,221212,216712,OK
300.485,TraderOne,Tick,816,801,15,-15,153100,153600,23488,221212,216712,OK
300.782,TraderOne,Tick,816,801,15,-15,153100,153600,23488,221212,216712,OK
301.047,TraderOne,Tick,816,801,15,-15,153100,153600,23488,221212,216712,OK
301.235,TraderOne,Tick,816,801,15,-15,153100,153700,23488,221212,216712,OK
301.547,TraderOne,Tick,816,801,15,-15,153100,153600,23488,221212,216712,OK
301.75,TraderOne,Tick,816,801,15,-15,153100,153600,23488,221212,216712,OK
302.063,TraderOne,Tick,816,801,15,-15,153100,153600,23488,221212,216712,OK
302.219,TraderOne,Tick,816,801,15,-15,153100,153600,23488,221212,216712,OK
302.516,TraderOne,Tick,816,801,15,-15,153100,153600,23488,221212,216712,OK
302.75,TraderOne,Tick,826,801,25,-25,153300,153600,23334,220366,212866,OK
302.985,TraderOne,Tick,826,801,25,-25,153700,153500,23334,220366,225366,OK
303.25,TraderOne,Tick,826,801,25,-25,153000,153300,23334,220366,212866,OK
303.485,TraderOne,Tick,826,801,25,-25,153000,153300,23334,220366,212866,OK
303.766,TraderOne,Tick,826,801,25,-25,153000,153400,23334,220366,212866,OK
303.985,TraderOne,Tick,826,801,25,-25,153000,153400,23334,220366,212866,OK
304.266,TraderOne,Tick,826,811,15,-15,154000,153200,23180,223520,228020,OK
304.469,TraderOne,Tick,826,811,15,-15,154000,153100,23180,223520,228020,OK
304.703,TraderOne,Tick,826,811,15,-15,154000,153100,23180,223520,228020,OK
305.032,TraderOne,Tick,836,821,15,-15,152500,152900,22874,225826,221326,OK
305.235,TraderOne,Tick,836,821,15,-15,152500,152900,22874,225826,221326,OK
305.5,TraderOne,Tick,836,821,15,-15,152500,152900,22874,225826,221326,OK
305.75,TraderOne,Tick,836,821,15,-15,152500,152800,22874,225826,221326,OK
306.047,TraderOne,Tick,836,821,15,-15,152500,152800,22874,225826,221326,OK
306.25,TraderOne,Tick,836,821,15,-15,152500,152800,22874,225826,221326,OK
306.516,TraderOne,Tick,846,821,25,-25,152500,152600,22721,224979,222479,OK
306.75,TraderOne,Tick,846,821,25,-25,152500,152600,22721,224979,222479,OK
307.016,TraderOne,Tick,846,821,25,-25,152500,152600,22721,224979,222479,OK
307.297,TraderOne,Tick,846,821,25,-25,152500,152900,22721,224979,217479,OK
307.469,TraderOne,Tick,846,821,25,-25,152500,152900,22721,224979,217479,OK
307.75,TraderOne,Tick,846,821,25,-25,152500,152900,22721,224979,217479,OK
308.0,TraderOne,Tick,846,821,25,-25,152500,152900,22721,224979,217479,OK
308.25,TraderOne,Tick,846,821,25,-25,152500,152900,22721,224979,217479,OK
308.485,TraderOne,Tick,846,821,25,-25,152500,152900,22721,224979,217479,OK
308.797,TraderOne,Tick,846,821,25,-25,152500,152900,22721,224979,217479,OK
308.969,TraderOne,Tick,846,821,25,-25,152500,152900,22721,224979,217479,OK
309.297,TraderOne,Tick,846,821,25,-25,152500,152900,22721,224979,217479,OK
309.516,TraderOne,Tick,856,841,15,-15,152600,153200,22722,229978,225478,OK
309.782,TraderOne,Tick,856,841,15,-15,152600,153400,22722,229978,225478,OK
310.0,TraderOne,Tick,856,841,15,-15,152600,153400,22722,229978,225478,OK
310.282,TraderOne,Tick,856,848,8,-8,153500,154100,22615,225185,222785,OK
310.516,TraderOne,Tick,856,848,8,-8,153500,154200,22615,225185,222785,OK
310.766,TraderOne,Tick,866,848,18,-18,153800,154200,22923,227877,222477,OK
310.969,TraderOne,Tick,876,848,28,-28,154100,154200,23231,229569,226769,OK
311.282,TraderOne,Tick,876,848,28,-28,154100,154200,23231,229569,226769,OK
311.453,TraderOne,Tick,876,848,28,-28,154100,154200,23231,229569,226769,OK
311.766,TraderOne,Tick,876,848,28,-28,154100,154200,23231,229569,226769,OK
311.953,TraderOne,Tick,876,848,28,-28,154100,154200,23231,229569,226769,OK
312.282,TraderOne,Tick,876,848,28,-28,154100,154200,23231,229569,226769,OK
312.485,TraderOne,Tick,876,848,28,-28,154100,154200,23231,229569,226769,OK
312.719,TraderOne,Tick,876,848,28,-28,153600,154200,23231,229569,221169,OK
312.969,TraderOne,Tick,876,848,28,-28,153600,154200,23231,229569,221169,OK
313.266,TraderOne,Tick,886,848,38,-38,154100,154300,23539,229261,221661,OK
313.516,TraderOne,Tick,886,848,38,-38,154500,154300,23539,229261,236861,OK
313.766,TraderOne,Tick,886,848,38,-38,154500,154300,23539,229261,236861,OK
314.0,TraderOne,Tick,886,848,38,-38,154500,154300,23539,229261,236861,OK
314.313,TraderOne,Tick,886,848,38,-38,154500,154300,23539,229261,236861,OK
314.469,TraderOne,Tick,886,848,38,-38,154500,154300,23539,229261,236861,OK
314.75,TraderOne,Tick,886,848,38,-38,154500,154300,23539,229261,236861,OK
315.047,TraderOne,Tick,886,848,38,-38,154500,154300,23539,229261,236861,OK
315.297,TraderOne,Tick,886,848,38,-38,154500,154300,23539,229261,236861,OK
315.469,TraderOne,Tick,886,848,38,-38,154500,154300,23539,229261,236861,OK
315.75,TraderOne,Tick,886,848,38,-38,154500,154300,23539,229261,236861,OK
315.985,TraderOne,Tick,886,848,38,-38,154500,154300,23539,229261,236861,OK
316.203,TraderOne,Tick,886,848,38,-38,154500,154300,23539,229261,236861,OK
316.547,TraderOne,Tick,886,848,38,-38,154500,154300,23539,229261,236861,OK
316.782,TraderOne,Tick,886,848,38,-38,154200,154300,23539,229261,225461,OK
317.0,TraderOne,Tick,886,848,38,-38,154300,154200,23539,229261,233061,OK
317.297,TraderOne,Tick,886,848,38,-38,154300,154200,23539,229261,233061,OK
317.469,TraderOne,Tick,886,848,38,-38,154500,154200,23539,229261,240661,OK
317.782,TraderOne,Tick,886,858,28,-28,154300,154200,23848,229952,232752,OK
317.969,TraderOne,Tick,886,868,18,-18,154300,154200,24157,232643,234443,OK
318.297,TraderOne,Tick,886,878,8,-8,154300,154200,24466,234334,235134,OK
318.453,TraderOne,Tick,886,878,8,-8,154300,153800,24466,234334,236734,OK
318.797,TraderOne,Tick,886,888,-2,2,154400,153800,24775,238025,237425,OK
319.0,TraderOne,Tick,886,888,-2,2,154400,153800,24775,238025,237425,OK
319.235,TraderOne,Tick,886,888,-2,2,154300,153800,24775,238025,237425,OK
319.469,TraderOne,Tick,886,888,-2,2,154300,153800,24775,238025,237425,OK
319.813,TraderOne,Tick,886,888,-2,2,154300,153700,24775,238025,237425,OK
320.016,TraderOne,Tick,886,888,-2,2,154400,153700,24775,238025,237425,OK
320.25,TraderOne,Tick,886,888,-2,2,154400,153700,24775,238025,237425,OK
320.547,TraderOne,Tick,886,888,-2,2,154400,153900,24775,238025,237425,OK
320.75,TraderOne,Tick,886,888,-2,2,154400,153900,24775,238025,237425,OK
321.0,TraderOne,Tick,886,888,-2,2,154400,153900,24775,238025,237425,OK
321.25,TraderOne,Tick,886,888,-2,2,154400,153900,24775,238025,237425,OK
321.516,TraderOne,Tick,886,888,-2,2,154400,153900,24775,238025,237425,OK
321.797,TraderOne,Tick,886,898,-12,12,154300,153800,25084,240716,237116,OK
322.047,TraderOne,Tick,886,908,-22,22,154300,153800,25393,245407,238807,OK
322.25,TraderOne,Tick,886,908,-22,22,154300,153800,25393,245407,238807,OK
322.516,TraderOne,Tick,886,918,-32,32,154200,153800,25701,249099,239499,OK
322.75,TraderOne,Tick,886,918,-32,32,154200,153800,25701,249099,239499,OK
323.047,TraderOne,Tick,886,918,-32,32,154200,153800,25701,249099,239499,OK
323.266,TraderOne,Tick,886,918,-32,32,154400,153800,25701,249099,239499,OK
323.485,TraderOne,Tick,886,918,-32,32,154400,153800,25701,249099,239499,OK
323.703,TraderOne,Tick,886,918,-32,32,154400,153800,25701,249099,239499,OK
323.969,TraderOne,Tick,886,918,-32,32,154400,153800,25701,249099,239499,OK
324.203,TraderOne,Tick,886,918,-32,32,154400,153800,25701,249099,239499,OK
324.453,TraderOne,Tick,886,918,-32,32,153900,153800,25701,249099,245899,OK
324.719,TraderOne,Tick,886,918,-32,32,153900,153800,25701,249099,245899,OK
324.969,TraderOne,Tick,886,918,-32,32,153900,153800,25701,249099,245899,OK
325.25,TraderOne,Tick,886,922,-36,36,153900,153600,25824,249376,238576,OK
325.453,TraderOne,Tick,886,922,-36,36,153000,153600,25824,249376,260176,OK
325.782,TraderOne,Tick,886,922,-36,36,153000,153600,25824,249376,260176,OK
325.953,TraderOne,Tick,886,922,-36,36,153000,153600,25824,249376,260176,OK
326.235,TraderOne,Tick,886,922,-36,36,153000,153600,25824,249376,260176,OK
326.516,TraderOne,Tick,886,922,-36,36,153000,153500,25824,249376,260176,OK
326.75,TraderOne,Tick,886,922,-36,36,153000,153500,25824,249376,260176,OK
327.047,TraderOne,Tick,886,922,-36,36,153000,153400,25824,249376,260176,OK
327.25,TraderOne,Tick,886,922,-36,36,153000,153400,25824,249376,260176,OK
327.547,TraderOne,Tick,886,922,-36,36,154000,153400,25824,249376,238576,OK
327.75,TraderOne,Tick,886,922,-36,36,154000,153400,25824,249376,238576,OK
328.0,TraderOne,Tick,886,922,-36,36,154000,153400,25824,249376,238576,OK
328.297,TraderOne,Tick,886,922,-36,36,152900,153400,25824,249376,260176,OK
328.5,TraderOne,Tick,886,922,-36,36,152900,153400,25824,249376,260176,OK
328.735,TraderOne,Tick,886,922,-36,36,152900,153400,25824,249376,260176,OK
329.047,TraderOne,Tick,886,922,-36,36,152900,153400,25824,249376,260176,OK
329.25,TraderOne,Tick,886,922,-36,36,152900,153400,25824,249376,260176,OK
329.469,TraderOne,Tick,886,922,-36,36,152900,153400,25824,249376,260176,OK
329.766,TraderOne,Tick,886,922,-36,36,152900,153400,25824,249376,260176,OK
329.985,TraderOne,Tick,886,922,-36,36,152900,153400,25824,249376,260176,OK
330.235,TraderOne,Tick,886,922,-36,36,152900,153400,25824,249376,260176,OK
330.485,TraderOne,Tick,886,922,-36,36,154000,153500,25824,249376,238576,OK
330.703,TraderOne,Tick,886,922,-36,36,154000,153500,25824,249376,238576,OK
331.032,TraderOne,Tick,886,922,-36,36,154000,153500,25824,249376,238576,OK
331.266,TraderOne,Tick,886,922,-36,36,154000,153400,25824,249376,238576,OK
331.5,TraderOne,Tick,886,922,-36,36,154000,153400,25824,249376,238576,OK
331.766,TraderOne,Tick,896,922,-26,26,152800,153400,25671,250529,258329,OK
331.969,TraderOne,Tick,896,922,-26,26,152800,153400,25671,250529,258329,OK
332.282,TraderOne,Tick,896,922,-26,26,152800,153400,25671,250529,258329,OK
332.532,TraderOne,Tick,896,922,-26,26,154000,153400,25671,250529,242729,OK
332.75,TraderOne,Tick,896,922,-26,26,154000,153400,25671,250529,242729,OK
333.047,TraderOne,Tick,896,922,-26,26,154000,153400,25671,250529,242729,OK
333.25,TraderOne,Tick,896,922,-26,26,154000,153400,25671,250529,242729,OK
333.516,TraderOne,Tick,896,922,-26,26,154000,153400,25671,250529,242729,OK
333.719,TraderOne,Tick,896,922,-26,26,154000,153400,25671,250529,242729,OK
333.985,TraderOne,Tick,896,922,-26,26,154000,153200,25671,250529,242729,OK
334.219,TraderOne,Tick,896,922,-26,26,154000,153200,25671,250529,242729,OK
334.516,TraderOne,Tick,896,922,-26,26,154000,153200,25671,250529,242729,OK
334.797,TraderOne,Tick,896,922,-26,26,154000,153200,25671,250529,242729,OK
335.0,TraderOne,Tick,896,922,-26,26,154000,153200,25671,250529,242729,OK
335.203,TraderOne,Tick,896,922,-26,26,154000,153200,25671,250529,242729,OK
335.516,TraderOne,Tick,896,922,-26,26,154000,153200,25671,250529,242729,OK
335.766,TraderOne,Tick,906,922,-16,16,152800,153200,25518,253682,258482,OK
335.985,TraderOne,Tick,906,922,-16,16,152800,153200,25518,253682,258482,OK
336.25,TraderOne,Tick,906,922,-16,16,152800,153200,25518,253682,258482,OK
336.5,TraderOne,Tick,906,922,-16,16,153800,153300,25518,253682,248882,OK
336.782,TraderOne,Tick,906,922,-16,16,153800,153300,25518,253682,248882,OK
337.047,TraderOne,Tick,906,922,-16,16,153800,153300,25518,253682,248882,OK
337.203,TraderOne,Tick,906,922,-16,16,153800,153300,25518,253682,248882,OK
337.453,TraderOne,Tick,906,922,-16,16,153800,153300,25518,253682,248882,OK
337.766,TraderOne,Tick,906,922,-16,16,153800,153300,25518,253682,248882,OK
337.953,TraderOne,Tick,906,922,-16,16,153800,153300,25518,253682,248882,OK
338.203,TraderOne,Tick,906,922,-16,16,153800,153300,25518,253682,248882,OK
338.516,TraderOne,Tick,906,922,-16,16,153800,153300,25518,253682,248882,OK
338.75,TraderOne,Tick,906,922,-16,16,153800,153300,25518,253682,248882,OK
338.985,TraderOne,Tick,906,922,-16,16,153800,153300,25518,253682,248882,OK
339.219,TraderOne,Tick,906,922,-16,16,154000,153300,25518,253682,248882,OK
339.547,TraderOne,Tick,906,922,-16,16,154000,153500,25518,253682,248882,OK
339.766,TraderOne,Tick,906,922,-16,16,154000,153500,25518,253682,248882,OK
340.047,TraderOne,Tick,906,922,-16,16,154000,153500,25518,253682,248882,OK
340.219,TraderOne,Tick,906,922,-16,16,154000,153500,25518,253682,248882,OK
340.5,TraderOne,Tick,906,922,-16,16,154000,153500,25518,253682,248882,OK
340.782,TraderOne,Tick,906,922,-16,16,153800,153300,25518,253682,248882,OK
341.016,TraderOne,Tick,906,922,-16,16,153800,153300,25518,253682,248882,OK
341.235,TraderOne,Tick,906,922,-16,16,153800,153300,25518,253682,248882,OK
341.547,TraderOne,Tick,906,922,-16,16,153800,153300,25518,253682,248882,OK
341.797,TraderOne,Tick,906,932,-26,26,153700,153300,25825,254375,246575,OK
342.016,TraderOne,Tick,906,932,-26,26,153700,153300,25825,254375,246575,OK
342.266,TraderOne,Tick,906,942,-36,36,153700,153300,26132,255068,244268,OK
342.453,TraderOne,Tick,906,942,-36,36,153700,153300,26132,255068,244268,OK
342.719,TraderOne,Tick,906,942,-36,36,153700,153300,26132,255068,244268,OK
342.985,TraderOne,Tick,906,942,-36,36,153700,153300,26132,255068,244268,OK
343.203,TraderOne,Tick,906,952,-46,46,153700,153300,26439,256761,242961,OK
343.516,TraderOne,Tick,906,952,-46,46,153700,153300,26439,256761,242961,OK
343.782,TraderOne,Tick,906,952,-46,46,153700,153300,26439,256761,242961,OK
343.985,TraderOne,Tick,916,952,-36,36,152800,153300,26286,258914,269714,OK
344.266,TraderOne,Tick,916,952,-36,36,152800,153000,26286,258914,266114,OK
344.516,TraderOne,Tick,916,952,-36,36,152800,153000,26286,258914,266114,OK
344.688,TraderOne,Tick,916,952,-36,36,152500,152900,26286,258914,269714,OK
344.985,TraderOne,Tick,916,952,-36,36,152500,152900,26286,258914,269714,OK
345.266,TraderOne,Tick,916,952,-36,36,152500,152900,26286,258914,269714,OK
345.516,TraderOne,Tick,916,952,-36,36,152500,152900,26286,258914,269714,OK
345.797,TraderOne,Tick,916,952,-36,36,152500,152700,26286,258914,266114,OK
346.016,TraderOne,Tick,916,952,-36,36,153400,152700,26286,258914,248114,OK
346.25,TraderOne,Tick,916,952,-36,36,153400,152700,26286,258914,248114,OK
346.547,TraderOne,Tick,916,952,-36,36,153400,152600,26286,258914,248114,OK
346.703,TraderOne,Tick,916,952,-36,36,153400,152800,26286,258914,248114,OK
346.953,TraderOne,Tick,916,952,-36,36,153400,152700,26286,258914,248114,OK
347.235,TraderOne,Tick,916,952,-36,36,153400,152700,26286,258914,248114,OK
347.485,TraderOne,Tick,916,952,-36,36,153400,152700,26286,258914,248114,OK
347.766,TraderOne,Tick,916,952,-36,36,152500,152700,26286,258914,266114,OK
348.016,TraderOne,Tick,916,952,-36,36,152500,152700,26286,258914,266114,OK
348.297,TraderOne,Tick,916,952,-36,36,152000,152700,26286,258914,269714,OK
348.469,TraderOne,Tick,916,952,-36,36,152000,152700,26286,258914,269714,OK
348.782,TraderOne,Tick,916,952,-36,36,152000,152600,26286,258914,269714,OK
348.969,TraderOne,Tick,916,952,-36,36,152000,152600,26286,258914,269714,OK
349.266,TraderOne,Tick,916,952,-36,36,152000,152600,26286,258914,269714,OK
349.453,TraderOne,Tick,916,952,-36,36,152000,152600,26286,258914,269714,OK
349.797,TraderOne,Tick,916,952,-36,36,152000,152600,26286,258914,269714,OK
350.0,TraderOne,Tick,916,952,-36,36,152000,152600,26286,258914,269714,OK
350.282,TraderOne,Tick,916,952,-36,36,152000,152600,26286,258914,269714,OK
350.469,TraderOne,Tick,916,952,-36,36,152000,152600,26286,258914,269714,OK
350.703,TraderOne,Tick,916,952,-36,36,152000,152600,26286,258914,269714,OK
350.953,TraderOne,Tick,916,952,-36,36,152000,152600,26286,258914,269714,OK
351.25,TraderOne,Tick,916,952,-36,36,152000,152500,26286,258914,269714,OK
351.485,TraderOne,Tick,916,952,-36,36,152000,152500,26286,258914,269714,OK
351.766,TraderOne,Tick,916,952,-36,36,152700,152500,26286,258914,251714,OK
352.0,TraderOne,Tick,916,962,-46,46,152700,152300,26591,260609,246809,OK
352.203,TraderOne,Tick,916,962,-46,46,152700,152300,26591,260609,246809,OK
352.5,TraderOne,Tick,916,972,-56,56,152700,152300,26896,262304,245504,OK
352.766,TraderOne,Tick,916,982,-66,66,152700,152300,27201,263999,244199,OK
352.953,TraderOne,Tick,916,982,-66,66,152700,152300,27201,263999,244199,OK
353.297,TraderOne,Tick,916,992,-76,76,152700,152300,27506,267694,244894,OK
353.547,TraderOne,Tick,916,997,-81,81,152700,152100,27659,270041,245741,OK
353.75,TraderOne,Tick,916,997,-81,81,152700,152100,27659,270041,245741,OK
354.032,TraderOne,Tick,916,997,-81,81,152700,152100,27659,270041,245741,OK
354.219,TraderOne,Tick,916,997,-81,81,152700,152100,27659,270041,245741,OK
354.5,TraderOne,Tick,916,997,-81,81,152700,152100,27659,270041,245741,OK
354.766,TraderOne,Tick,916,997,-81,81,152700,152100,27659,270041,245741,OK
354.985,TraderOne,Tick,916,997,-81,81,152700,152100,27659,270041,245741,OK
355.282,TraderOne,Tick,916,997,-81,81,152700,152100,27659,270041,245741,OK
355.5,TraderOne,Tick,916,1007,-91,91,152800,152100,27506,271194,243894,OK
355.766,TraderOne,Tick,916,1007,-91,91,152800,152500,27506,271194,243894,OK
355.969,TraderOne,Tick,916,1007,-91,91,152800,152500,27506,271194,243894,OK
356.235,TraderOne,Tick,916,1007,-91,91,152800,152500,27506,271194,243894,OK
356.485,TraderOne,Tick,916,1007,-91,91,152800,152400,27506,271194,243894,OK
356.782,TraderOne,Tick,916,1007,-91,91,152800,152400,27506,271194,243894,OK
357.032,TraderOne,Tick,916,1007,-91,91,152800,152400,27506,271194,243894,OK
357.235,TraderOne,Tick,916,1007,-91,91,152800,152400,27506,271194,243894,OK
357.469,TraderOne,Tick,916,1007,-91,91,153000,152400,27506,271194,243894,OK
357.703,TraderOne,Tick,916,1007,-91,91,153000,152400,27506,271194,243894,OK
358.016,TraderOne,Tick,916,1007,-91,91,153000,152400,27506,271194,243894,OK
358.313,TraderOne,Tick,916,1007,-91,91,153000,152400,27506,271194,243894,OK
358.5,TraderOne,Tick,916,1007,-91,91,153000,152100,27506,271194,243894,OK
358.719,TraderOne,Tick,916,1007,-91,91,153000,152100,27506,271194,243894,OK
359.0,TraderOne,Tick,916,1007,-91,91,152600,152100,27506,271194,243894,OK
359.203,TraderOne,Tick,916,1007,-91,91,152600,152100,27506,271194,243894,OK
359.5,TraderOne,Tick,916,1007,-91,91,152600,152100,27506,271194,243894,OK
359.797,TraderOne,Tick,916,1007,-91,91,152600,151400,27506,271194,243894,OK
360.016,TraderOne,Tick,916,1007,-91,91,152100,151400,27506,271194,243894,OK
360.203,TraderOne,Tick,916,1007,-91,91,152100,151400,27506,271194,243894,OK
360.485,TraderOne,Tick,916,1007,-91,91,152100,151800,27506,271194,243894,OK
360.782,TraderOne,Tick,916,1007,-91,91,152400,152000,27506,271194,243894,OK
361.016,TraderOne,Tick,916,1007,-91,91,152400,152300,27506,271194,262094,OK
361.203,TraderOne,Tick,916,1007,-91,91,152400,152300,27506,271194,262094,OK
361.547,TraderOne,Tick,916,1007,-91,91,152400,152300,27506,271194,262094,OK
361.719,TraderOne,Tick,916,1007,-91,91,152400,152300,27506,271194,262094,OK
361.969,TraderOne,Tick,916,1007,-91,91,152600,152300,27506,271194,243894,OK
362.266,TraderOne,Tick,916,1007,-91,91,151900,152300,27506,271194,298494,OK
362.453,TraderOne,Tick,916,1007,-91,91,152500,152300,27506,271194,252994,OK
362.797,TraderOne,Tick,916,1007,-91,91,152500,152100,27506,271194,243894,OK
363.032,TraderOne,Tick,916,1007,-91,91,152500,152100,27506,271194,243894,OK
363.282,TraderOne,Tick,916,1007,-91,91,152500,152100,27506,271194,243894,OK
363.453,TraderOne,Tick,916,1007,-91,91,152500,152100,27506,271194,243894,OK
363.797,TraderOne,Tick,916,1007,-91,91,152500,152100,27506,271194,243894,OK
364.016,TraderOne,Tick,916,1007,-91,91,152500,152100,27506,271194,243894,OK
364.313,TraderOne,Tick,916,1007,-91,91,152200,152100,27506,271194,262094,OK
364.485,TraderOne,Tick,916,1007,-91,91,152200,152100,27506,271194,262094,OK
364.719,TraderOne,Tick,916,1007,-91,91,151900,152100,27506,271194,289394,OK
364.985,TraderOne,Tick,916,1007,-91,91,151800,152100,27506,271194,298494,OK
365.297,TraderOne,Tick,916,1007,-91,91,151800,152100,27506,271194,298494,OK
365.453,TraderOne,Tick,916,1007,-91,91,151800,152100,27506,271194,298494,OK
365.735,TraderOne,Tick,916,1007,-91,91,151800,152100,27506,271194,298494,OK
366.0,TraderOne,Tick,916,1007,-91,91,152200,152100,27506,271194,262094,OK
366.282,TraderOne,Tick,916,1007,-91,91,151800,152100,27506,271194,298494,OK
366.516,TraderOne,Tick,916,1007,-91,91,152000,151500,27506,271194,243894,OK
366.75,TraderOne,Tick,916,1007,-91,91,152000,151500,27506,271194,243894,OK
366.985,TraderOne,Tick,916,1007,-91,91,152000,151500,27506,271194,243894,OK
367.235,TraderOne,Tick,916,1007,-91,91,152100,151500,27506,271194,243894,OK
367.5,TraderOne,Tick,916,1007,-91,91,152100,151500,27506,271194,243894,OK
367.75,TraderOne,Tick,916,1007,-91,91,152100,151800,27506,271194,243894,OK
367.953,TraderOne,Tick,916,1007,-91,91,152100,151800,27506,271194,243894,OK
368.25,TraderOne,Tick,916,1007,-91,91,152100,151800,27506,271194,243894,OK
368.485,TraderOne,Tick,916,1007,-91,91,152100,151800,27506,271194,243894,OK
368.735,TraderOne,Tick,916,1007,-91,91,152100,151800,27506,271194,243894,OK
369.016,TraderOne,Tick,916,1007,-91,91,152100,151700,27506,271194,243894,OK
369.282,TraderOne,Tick,916,1007,-91,91,152100,151700,27506,271194,243894,OK
369.5,TraderOne,Tick,916,1007,-91,91,152100,151700,27506,271194,243894,OK
369.782,TraderOne,Tick,916,1007,-91,91,152100,151700,27506,271194,243894,OK
370.032,TraderOne,Tick,916,1007,-91,91,152100,152000,27506,271194,262094,OK
370.266,TraderOne,Tick,916,1007,-91,91,152100,152000,27506,271194,262094,OK
370.469,TraderOne,Tick,916,1007,-91,91,152100,152000,27506,271194,262094,OK
370.797,TraderOne,Tick,916,1007,-91,91,152100,152000,27506,271194,262094,OK
370.969,TraderOne,Tick,916,1007,-91,91,152100,152000,27506,271194,262094,OK
371.266,TraderOne,Tick,916,1007,-91,91,152100,152000,27506,271194,262094,OK
371.5,TraderOne,Tick,916,1007,-91,91,152100,152000,27506,271194,262094,OK
371.766,TraderOne,Tick,916,1007,-91,91,152100,152000,27506,271194,262094,OK
372.032,TraderOne,Tick,916,1007,-91,91,152100,152000,27506,271194,262094,OK
372.25,TraderOne,Tick,926,1007,-81,81,151900,152000,27810,272890,280990,OK
372.5,TraderOne,Tick,926,1007,-81,81,151900,152000,27810,272890,280990,OK
372.813,TraderOne,Tick,936,1007,-71,71,151900,152000,28114,273586,280686,OK
373.0,TraderOne,Tick,946,1007,-61,61,151900,152000,28418,274282,280382,OK
373.297,TraderOne,Tick,956,1017,-61,61,152200,152000,28570,276130,263930,OK
373.5,TraderOne,Tick,956,1025,-69,69,152300,152000,28814,279086,258386,OK
373.797,TraderOne,Tick,956,1025,-69,69,152300,152000,28814,279086,258386,OK
374.016,TraderOne,Tick,956,1025,-69,69,152300,152000,28814,279086,258386,OK
374.203,TraderOne,Tick,956,1025,-69,69,152300,152000,28814,279086,258386,OK
374.532,TraderOne,Tick,956,1025,-69,69,152300,152000,28814,279086,258386,OK
374.782,TraderOne,Tick,956,1025,-69,69,152300,152000,28814,279086,258386,OK
374.985,TraderOne,Tick,956,1025,-69,69,152300,152000,28814,279086,258386,OK
375.297,TraderOne,Tick,956,1025,-69,69,152300,152000,28814,279086,258386,OK
375.5,TraderOne,Tick,956,1025,-69,69,152400,152000,28814,279086,258386,OK
375.719,TraderOne,Tick,956,1025,-69,69,152400,152000,28814,279086,258386,OK
376.032,TraderOne,Tick,956,1025,-69,69,152400,152000,28814,279086,258386,OK
376.235,TraderOne,Tick,956,1025,-69,69,152400,152000,28814,279086,258386,OK
376.453,TraderOne,Tick,956,1025,-69,69,152400,152000,28814,279086,258386,OK
376.703,TraderOne,Tick,956,1025,-69,69,152400,152000,28814,279086,258386,OK
377.016,TraderOne,Tick,956,1025,-69,69,151900,152000,28814,279086,285986,OK
377.235,TraderOne,Tick,956,1025,-69,69,151900,152000,28814,279086,285986,OK
377.453,TraderOne,Tick,956,1025,-69,69,151900,152300,28814,279086,299786,OK
377.797,TraderOne,Tick,956,1025,-69,69,151900,152300,28814,279086,299786,OK
378.016,TraderOne,Tick,956,1025,-69,69,151900,152300,28814,279086,299786,OK
378.266,TraderOne,Tick,956,1035,-79,79,152600,152300,28662,279238,255538,OK
378.516,TraderOne,Tick,956,1035,-79,79,151800,152300,28662,279238,302938,OK
378.75,TraderOne,Tick,956,1045,-89,89,152600,152300,28510,280390,253690,OK
378.985,TraderOne,Tick,966,1055,-89,89,151800,152300,28663,284237,310937,OK
379.25,TraderOne,Tick,966,1055,-89,89,151800,152300,28663,284237,310937,OK
379.547,TraderOne,Tick,966,1055,-89,89,151800,152300,28663,284237,310937,OK
379.703,TraderOne,Tick,966,1055,-89,89,151800,152300,28663,284237,310937,OK
380.047,TraderOne,Tick,974,1055,-81,81,152200,152300,28541,283559,291659,OK
380.297,TraderOne,Tick,974,1055,-81,81,152200,152300,28541,283559,291659,OK
380.485,TraderOne,Tick,974,1055,-81,81,152200,152300,28541,283559,291659,OK
380.75,TraderOne,Tick,984,1055,-71,71,151600,152300,28389,284711,306011,OK
381.016,TraderOne,Tick,984,1055,-71,71,151600,152300,28389,284711,306011,OK
381.25,TraderOne,Tick,984,1055,-71,71,151600,152300,28389,284711,306011,OK
381.469,TraderOne,Tick,984,1055,-71,71,151600,152300,28389,284711,306011,OK
381.703,TraderOne,Tick,984,1065,-81,71,152900,152300,28237,1809863,262563,OK
382.047,TraderOne,Tick,984,1065,-81,81,152900,152500,28237,284863,260563,OK
382.266,TraderOne,Tick,991,1065,-74,74,151900,152500,28450,288150,310350,OK
382.516,TraderOne,Tick,991,1065,-74,74,151900,152500,28450,288150,310350,OK
382.703,TraderOne,Tick,991,1065,-74,74,151900,152500,28450,288150,310350,OK
383.016,TraderOne,Tick,991,1065,-74,74,151900,152500,28450,288150,310350,OK
383.297,TraderOne,Tick,991,1065,-74,74,151900,152500,28450,288150,310350,OK
383.516,TraderOne,Tick,991,1075,-84,84,152900,152500,28297,288303,263103,OK
383.797,TraderOne,Tick,991,1085,-94,94,152900,152500,28603,290997,262797,OK
384.016,TraderOne,Tick,991,1085,-94,94,152900,152500,28603,290997,262797,OK
384.25,TraderOne,Tick,991,1085,-94,94,152900,152500,28603,290997,262797,OK
384.485,TraderOne,Tick,991,1085,-94,94,152900,152500,28603,290997,262797,OK
384.719,TraderOne,Tick,991,1085,-94,94,152900,152500,28603,290997,262797,OK
384.969,TraderOne,Tick,991,1085,-94,94,152900,152500,28603,290997,262797,OK
385.282,TraderOne,Tick,991,1085,-94,94,152900,152500,28603,290997,262797,OK
385.547,TraderOne,Tick,1001,1085,-84,84,152200,152500,28451,292149,317349,OK
385.766,TraderOne,Tick,1001,1085,-84,84,152200,152500,28451,292149,317349,OK
386.016,TraderOne,Tick,1001,1085,-84,84,152200,152500,28451,292149,317349,OK
386.235,TraderOne,Tick,1001,1085,-84,84,152200,152500,28451,292149,317349,OK
386.532,TraderOne,Tick,1011,1085,-74,74,151800,152500,28299,291301,313501,OK
386.766,TraderOne,Tick,1011,1085,-74,74,151800,152500,28299,291301,313501,OK
387.032,TraderOne,Tick,1011,1085,-74,74,151800,152300,28299,291301,313501,OK
387.266,TraderOne,Tick,1011,1085,-74,74,151800,152300,28299,291301,313501,OK
387.5,TraderOne,Tick,1011,1085,-74,74,152900,152300,28299,291301,269101,OK
387.75,TraderOne,Tick,1011,1085,-74,74,152900,152300,28299,291301,269101,OK
387.969,TraderOne,Tick,1011,1085,-74,74,152900,152300,28299,291301,269101,OK
388.219,TraderOne,Tick,1011,1085,-74,74,152900,152300,28299,291301,269101,OK
388.516,TraderOne,Tick,1011,1085,-74,74,151700,152200,28299,291301,313501,OK
388.75,TraderOne,Tick,1011,1085,-74,74,151700,152200,28299,291301,313501,OK
389.047,TraderOne,Tick,1011,1085,-74,74,151700,152200,28299,291301,313501,OK
389.25,TraderOne,Tick,1011,1095,-84,84,152900,152400,28147,291453,266253,OK
389.516,TraderOne,Tick,1011,1095,-84,84,152900,152400,28147,291453,266253,OK
389.703,TraderOne,Tick,1011,1095,-84,84,152900,152400,28147,291453,266253,OK
389.985,TraderOne,Tick,1011,1095,-84,84,152900,152200,28147,291453,266253,OK
390.235,TraderOne,Tick,1011,1095,-84,84,152900,152200,28147,291453,266253,OK
390.5,TraderOne,Tick,1011,1095,-84,84,152900,152200,28147,291453,266253,OK
390.797,TraderOne,Tick,1011,1095,-84,84,152900,152100,28147,291453,266253,OK
390.985,TraderOne,Tick,1011,1095,-84,84,152900,152100,28147,291453,266253,OK
391.25,TraderOne,Tick,1011,1095,-84,84,152900,152100,28147,291453,266253,OK
391.547,TraderOne,Tick,1011,1095,-84,84,152900,152100,28147,291453,266253,OK
391.766,TraderOne,Tick,1011,1095,-84,84,152900,152100,28147,291453,266253,OK
392.016,TraderOne,Tick,1011,1095,-84,84,152900,152100,28147,291453,266253,OK
392.235,TraderOne,Tick,1011,1095,-84,84,152900,152100,28147,291453,266253,OK
392.485,TraderOne,Tick,1011,1095,-84,84,152900,152100,28147,291453,266253,OK
392.797,TraderOne,Tick,1011,1095,-84,84,152900,152100,28147,291453,266253,OK
393.0,TraderOne,Tick,1011,1095,-84,84,152900,152100,28147,291453,266253,OK
393.25,TraderOne,Tick,1011,1095,-84,84,152900,152200,28147,291453,266253,OK
393.485,TraderOne,Tick,1011,1095,-84,84,152900,152200,28147,291453,266253,OK
393.766,TraderOne,Tick,1011,1095,-84,84,152900,152500,28147,291453,266253,OK
393.985,TraderOne,Tick,1011,1105,-94,94,152700,152500,28452,292148,273348,OK
394.266,TraderOne,Tick,1011,1105,-94,94,152700,152400,28452,292148,263948,OK
394.516,TraderOne,Tick,1011,1105,-94,94,152700,152400,28452,292148,263948,OK
394.797,TraderOne,Tick,1011,1105,-94,94,152700,152400,28452,292148,263948,OK
395.0,TraderOne,Tick,1011,1105,-94,94,152900,152400,28452,292148,263948,OK
395.25,TraderOne,Tick,1011,1105,-94,94,152900,152400,28452,292148,263948,OK
395.5,TraderOne,Tick,1011,1105,-94,94,152900,152400,28452,292148,263948,OK
395.75,TraderOne,Tick,1021,1105,-84,84,152200,152300,28300,292300,300700,OK
396.063,TraderOne,Tick,1021,1105,-84,84,151900,152300,28300,292300,317500,OK
396.297,TraderOne,Tick,1021,1105,-84,84,151900,152300,28300,292300,317500,OK
396.485,TraderOne,Tick,1021,1105,-84,84,151900,152300,28300,292300,317500,OK
396.703,TraderOne,Tick,1021,1105,-84,84,151900,152300,28300,292300,317500,OK
397.016,TraderOne,Tick,1021,1105,-84,84,151900,151700,28300,292300,275500,OK
397.266,TraderOne,Tick,1021,1105,-84,84,151900,151400,28300,292300,267100,OK
397.5,TraderOne,Tick,1021,1115,-94,94,151900,151400,28604,296996,268796,OK
397.797,TraderOne,Tick,1021,1115,-94,94,151800,151400,28604,296996,268796,OK
397.985,TraderOne,Tick,1021,1115,-94,94,151800,151400,28604,296996,268796,OK
398.282,TraderOne,Tick,1021,1115,-94,94,151800,151400,28604,296996,268796,OK
398.5,TraderOne,Tick,1021,1115,-94,94,151600,151100,28604,296996,268796,OK
398.782,TraderOne,Tick,1021,1115,-94,94,151600,151100,28604,296996,268796,OK
399.0,TraderOne,Tick,1021,1115,-94,94,151600,151100,28604,296996,268796,OK
399.282,TraderOne,Tick,1021,1115,-94,94,151600,151200,28604,296996,268796,OK
399.532,TraderOne,Tick,1021,1115,-94,94,151600,151200,28604,296996,268796,OK
399.735,TraderOne,Tick,1021,1115,-94,94,151400,151200,28604,296996,278196,OK
400.0,TraderOne,Tick,1021,1115,-94,94,151400,151200,28604,296996,278196,OK
400.297,TraderOne,Tick,1021,1115,-94,94,151400,151200,28604,296996,278196,OK
400.453,TraderOne,Tick,1021,1115,-94,94,151400,151200,28604,296996,278196,OK
400.719,TraderOne,Tick,1021,1115,-94,94,151400,151000,28604,296996,268796,OK
400.969,TraderOne,Tick,1021,1115,-94,94,151400,151000,28604,296996,268796,OK
401.266,TraderOne,Tick,1021,1115,-94,94,151300,151000,28604,296996,268796,OK
401.485,TraderOne,Tick,1021,1115,-94,94,151300,151000,28604,296996,268796,OK
401.766,TraderOne,Tick,1021,1115,-94,94,151300,151000,28604,296996,268796,OK
402.032,TraderOne,Tick,1021,1115,-94,94,151300,151000,28604,296996,268796,OK
402.297,TraderOne,Tick,1021,1115,-94,94,151300,150900,28604,296996,268796,OK
402.532,TraderOne,Tick,1021,1115,-94,94,151400,150900,28604,296996,268796,OK
402.719,TraderOne,Tick,1021,1115,-94,94,151400,150900,28604,296996,268796,OK
403.047,TraderOne,Tick,1021,1115,-94,94,151400,150900,28604,296996,268796,OK
403.25,TraderOne,Tick,1021,1115,-94,94,151400,150900,28604,296996,268796,OK
403.516,TraderOne,Tick,1021,1115,-94,94,151400,150900,28604,296996,268796,OK
403.766,TraderOne,Tick,1021,1115,-94,94,151400,150900,28604,296996,268796,OK
404.0,TraderOne,Tick,1021,1115,-94,94,151400,150900,28604,296996,268796,OK
404.203,TraderOne,Tick,1021,1115,-94,94,151400,150900,28604,296996,268796,OK
404.485,TraderOne,Tick,1021,1115,-94,94,151400,150900,28604,296996,268796,OK
404.719,TraderOne,Tick,1021,1115,-94,94,151400,150900,28604,296996,268796,OK
405.047,TraderOne,Tick,1021,1115,-94,94,151400,150900,28604,296996,268796,OK
405.282,TraderOne,Tick,1021,1115,-94,94,151400,150900,28604,296996,268796,OK
405.469,TraderOne,Tick,1021,1115,-94,94,151300,151000,28604,296996,268796,OK
405.813,TraderOne,Tick,1021,1115,-94,94,151300,151000,28604,296996,268796,OK
406.047,TraderOne,Tick,1021,1115,-94,94,151300,151000,28604,296996,268796,OK
406.266,TraderOne,Tick,1021,1115,-94,94,151300,151000,28604,296996,268796,OK
406.5,TraderOne,Tick,1021,1115,-94,94,151300,151000,28604,296996,268796,OK
406.735,TraderOne,Tick,1021,1115,-94,94,151300,151000,28604,296996,268796,OK
406.969,TraderOne,Tick,1021,1115,-94,94,151400,151000,28604,296996,268796,OK
407.25,TraderOne,Tick,1021,1115,-94,94,151400,151000,28604,296996,268796,OK
407.5,TraderOne,Tick,1021,1115,-94,94,151200,151000,28604,296996,278196,OK
407.75,TraderOne,Tick,1021,1115,-94,94,151200,150500,28604,296996,268796,OK
407.969,TraderOne,Tick,1021,1115,-94,94,151100,150500,28604,296996,268796,OK
408.297,TraderOne,Tick,1021,1115,-94,94,151000,150500,28604,296996,268796,OK
408.5,TraderOne,Tick,1021,1115,-94,94,150900,150500,28604,296996,268796,OK
408.75,TraderOne,Tick,1021,1115,-94,94,150900,150500,28604,296996,268796,OK
409.032,TraderOne,Tick,1021,1115,-94,94,150700,150500,28604,296996,278196,OK
409.203,TraderOne,Tick,1021,1115,-94,94,150700,150500,28604,296996,278196,OK
409.485,TraderOne,Tick,1021,1115,-94,94,150700,150500,28604,296996,278196,OK
409.703,TraderOne,Tick,1021,1115,-94,94,150700,150000,28604,296996,268796,OK
